0 0 0 0 0 0 0 0 0 0 0 0 0 0 0 0 0 0 0 0 0 0 0 0 0 0 0 0 0 0 0 0 0 0 0 0 0 0 0 0 0 0 0 0 0 0 0 0 0 0 0 0 0 0 0 0 0 0 0 0 0 0 0 0 0 0 0 0 0 11 11 11 11 11 11 11 11 11 11 11 11 11 0 0 0 0 0 11 0 0 0 0 0 0 0 0 0 0 31 
0 0 0 0 0 0 0 0 0 0 0 0 0 0 0 0 0 0 0 0 0 0 0 0 0 0 0 0 0 0 0 0 0 0 0 0 0 0 0 0 0 0 0 0 0 0 0 0 0 0 0 0 0 0 0 0 0 0 0 0 0 0 0 0 0 0 0 0 0 11 0 0 0 0 0 0 0 0 0 0 0 11 0 0 0 0 0 11 0 0 0 0 0 0 0 0 0 0 31 
0 0 0 11 0 0 0 11 0 0 0 11 11 11 11 11 11 11 11 11 11 11 11 11 11 11 11 0 0 11 0 0 0 0 0 0 0 0 0 11 0 0 0 0 0 0 0 0 0 0 0 0 0 0 0 0 0 0 0 0 0 0 0 0 0 0 0 0 0 11 0 0 11 11 11 11 11 11 11 11 11 11 0 0 0 0 0 11 0 0 0 0 0 0 0 0 0 0 31 
0 0 0 11 0 0 0 11 0 0 0 11 0 0 0 0 0 0 0 0 0 0 0 0 0 0 0 0 0 11 0 0 0 0 0 0 0 0 0 11 0 0 0 0 11 11 11 11 11 11 11 11 11 11 11 11 11 11 11 11 11 11 11 11 11 11 0 0 0 11 0 0 0 0 0 0 0 0 0 0 0 11 0 0 0 0 0 11 0 0 0 0 0 0 0 0 0 0 31 
0 0 0 11 0 0 0 11 0 0 0 11 0 0 0 0 0 0 0 0 0 0 0 0 0 0 0 0 0 11 0 0 0 0 0 0 0 0 0 11 0 0 0 0 0 0 0 0 0 0 0 0 0 0 0 0 0 0 0 0 0 0 0 0 0 11 0 0 0 11 0 0 0 0 0 0 0 0 0 0 0 11 0 11 11 11 11 11 11 11 11 11 11 11 11 11 11 11 31 11 11 
0 0 0 11 0 0 0 11 0 0 0 11 0 0 0 0 0 0 0 0 0 0 0 0 0 0 0 0 0 11 0 0 0 11 11 0 0 0 0 11 0 0 0 0 0 0 0 0 0 0 0 0 0 0 0 0 0 0 0 0 0 0 0 0 0 11 0 0 0 0 0 0 0 0 0 0 0 0 0 0 0 11 0 0 0 0 0 11 0 0 0 0 0 0 0 0 0 0 31 0 0 0 0 0 12 12 12 12 
0 0 0 11 1 0 0 0 0 0 0 11 11 11 11 11 11 11 11 11 11 11 11 11 11 11 11 11 11 11 11 11 11 11 11 11 11 0 0 11 11 0 0 0 0 0 0 0 0 0 0 0 0 0 0 0 0 0 0 0 0 0 0 0 0 11 0 0 11 11 11 0 0 0 11 11 11 0 0 0 0 11 0 0 0 0 0 11 0 0 0 0 0 0 0 0 0 0 31 0 0 0 12 12 0 12 
0 0 0 11 1 1 0 0 0 0 0 0 0 0 0 0 0 0 0 0 0 0 0 0 0 0 0 0 0 0 0 0 0 0 11 0 11 11 0 0 0 11 0 0 0 0 0 0 0 0 0 0 0 0 0 0 0 0 0 0 0 0 0 0 0 11 0 0 0 11 0 0 0 0 11 0 0 0 0 0 11 11 11 11 11 0 0 11 0 0 0 0 0 0 0 0 0 0 31 0 0 12 0 0 0 12 
0 0 0 11 11 11 11 11 11 11 11 11 0 0 0 0 0 0 0 0 0 0 0 0 0 0 0 0 0 0 0 0 0 0 11 0 0 11 11 0 0 11 0 0 0 0 0 0 0 0 0 0 0 0 0 0 0 0 0 0 0 0 0 0 11 11 0 0 0 11 0 0 0 0 11 0 0 0 0 0 0 11 0 0 0 0 0 11 0 0 0 0 0 0 0 0 0 0 31 0 0 0 0 0 0 12 
0 0 0 0 0 0 0 0 0 0 0 0 0 0 0 0 0 0 0 0 0 0 0 0 0 0 0 0 0 0 0 0 0 0 11 0 0 0 11 11 0 11 0 0 0 0 11 11 11 11 11 11 11 0 0 0 0 0 0 0 0 0 0 11 11 11 0 0 0 11 0 0 0 0 11 11 11 11 0 0 0 11 0 0 0 0 0 11 0 0 12 0 0 0 0 0 0 0 31 0 0 0 0 0 0 12 
0 0 0 0 0 0 0 0 0 0 0 0 6 0 0 0 0 0 0 0 0 0 0 0 0 0 0 0 0 0 0 0 0 0 11 0 0 0 0 0 0 11 11 0 0 0 0 0 0 0 0 0 0 0 0 0 0 0 0 0 0 0 11 11 11 11 11 0 0 11 0 0 11 0 11 0 0 0 0 0 0 11 0 0 11 11 11 11 0 12 0 12 0 0 0 12 12 12 12 0 0 0 0 0 0 12 12 
0 0 0 0 0 0 0 0 0 0 0 0 6 0 0 0 0 0 0 0 0 0 0 0 0 0 0 0 0 0 0 0 0 0 11 0 11 11 11 11 0 0 11 11 0 0 0 0 0 0 0 0 0 0 0 0 0 0 0 0 11 11 11 11 11 11 0 0 0 11 0 0 0 0 11 0 0 0 0 0 0 11 0 0 0 0 0 11 0 0 12 0 0 0 0 0 0 0 31 0 0 0 0 0 0 12 
0 0 0 0 0 0 0 0 0 0 0 0 6 0 0 0 0 0 0 0 0 0 0 0 0 0 0 0 0 0 0 0 0 0 11 0 0 0 0 11 11 0 0 11 11 11 11 11 11 11 11 11 11 11 11 11 0 0 0 0 0 0 0 0 0 11 0 0 0 11 11 0 0 0 11 0 0 0 0 0 11 11 11 0 0 0 0 11 0 0 0 0 0 0 0 0 0 0 31 0 0 0 0 0 0 12 
0 0 0 0 0 0 0 0 0 0 0 0 6 6 6 11 11 0 0 0 0 0 0 0 0 0 0 0 0 0 0 0 0 0 11 0 0 0 0 0 11 11 0 0 0 0 0 0 0 0 0 0 0 0 0 0 0 0 0 0 0 0 0 0 0 11 0 0 11 11 0 0 0 0 11 0 0 0 0 0 0 11 0 0 0 0 0 11 0 0 0 0 0 0 0 0 0 0 31 0 0 0 12 0 0 12 0 12 
0 0 0 0 0 0 0 0 0 0 0 0 6 0 11 6 11 0 0 0 0 0 0 0 0 0 0 0 0 0 0 0 0 0 11 11 11 0 0 0 0 11 11 0 0 0 0 0 0 0 0 0 0 0 0 0 0 0 0 0 0 0 0 0 0 11 0 0 0 11 0 0 0 0 11 11 0 0 0 0 0 11 0 0 0 0 0 11 0 0 0 0 0 0 0 0 0 0 31 0 0 0 12 0 0 12 
0 0 6 6 6 6 6 6 6 6 6 6 6 6 6 6 11 0 0 0 0 0 0 0 0 0 0 0 0 0 0 0 0 0 0 0 0 11 0 0 0 0 11 11 11 11 11 11 11 11 11 11 11 11 0 0 11 11 11 11 0 0 0 0 0 11 0 0 0 11 0 0 11 0 11 0 0 0 0 0 0 11 11 11 11 0 0 11 0 0 0 12 12 12 12 12 12 12 12 0 0 0 12 0 0 12 
0 0 0 0 0 0 0 0 0 0 0 0 0 0 0 0 11 1 0 0 0 0 0 0 0 0 0 0 0 0 0 0 0 0 0 0 0 0 0 0 0 0 0 0 0 0 0 11 0 0 0 0 0 11 0 0 0 0 0 11 0 0 0 0 0 11 11 0 0 0 0 0 11 0 0 0 0 0 0 0 0 0 0 0 0 0 0 11 0 0 0 0 0 0 0 0 0 0 0 0 0 0 12 0 0 12 12 
6 0 0 0 0 0 0 0 0 0 0 0 0 0 0 0 11 11 11 11 11 0 0 0 0 0 0 0 0 0 11 0 0 11 0 0 0 0 0 0 0 0 0 0 0 0 0 11 0 0 0 0 0 11 0 0 0 0 0 11 0 0 0 0 0 11 11 11 11 11 11 11 11 11 11 11 11 11 11 11 11 11 0 0 0 0 0 11 0 0 0 0 0 0 0 0 0 0 0 0 0 0 12 0 12 12 
6 6 0 0 0 0 0 0 0 0 0 0 0 0 0 0 0 0 0 0 0 0 0 0 0 0 0 0 0 11 11 0 0 11 11 0 0 0 0 0 0 0 0 0 0 0 0 11 0 0 0 0 0 11 1 0 0 0 0 11 11 0 0 0 0 0 0 0 0 0 0 0 0 0 0 0 0 0 0 0 0 0 0 0 0 0 11 11 11 0 0 0 0 0 0 0 0 0 0 0 0 12 12 
6 6 6 0 0 0 0 0 0 0 0 0 0 0 0 0 0 0 0 0 0 0 0 0 11 11 11 11 11 11 11 0 0 11 11 11 11 11 11 11 11 11 11 11 0 0 0 11 11 11 0 0 0 11 11 11 0 0 0 11 0 0 0 0 0 0 0 0 0 0 0 0 0 0 0 0 0 0 0 0 0 0 0 0 11 11 0 11 0 0 0 0 0 0 0 0 0 0 0 0 0 0 12 0 0 0 0 12 
6 6 6 6 0 0 0 0 0 0 0 0 0 0 0 0 0 0 0 0 0 0 0 0 0 0 0 0 0 0 0 0 0 0 0 0 0 0 0 0 0 0 0 0 11 0 0 0 0 0 0 0 11 0 0 0 0 0 0 11 0 0 0 0 0 0 0 0 0 0 0 0 0 0 0 0 0 0 0 0 0 0 11 11 0 0 0 11 0 0 0 0 0 0 0 0 0 0 12 0 0 0 12 12 12 12 12 12 
6 6 6 6 6 0 0 0 0 0 0 0 0 0 0 0 0 0 0 0 0 0 1 0 0 0 0 0 0 0 0 0 0 0 0 0 0 0 0 0 0 0 0 0 0 11 0 0 0 0 0 11 0 0 0 0 0 0 0 11 0 0 11 0 0 0 0 0 0 0 0 0 0 0 0 0 0 0 0 0 0 0 0 0 11 11 0 11 0 0 0 12 12 12 12 12 12 12 12 0 0 0 0 0 0 0 0 12 
6 6 6 6 6 6 0 0 0 0 0 0 0 0 0 0 0 0 0 0 0 1 2 1 0 0 0 0 0 0 0 0 0 0 0 0 0 0 0 0 0 0 0 0 0 0 11 0 0 0 11 0 0 0 0 0 0 0 0 11 0 0 11 0 0 0 0 0 0 0 0 0 0 0 0 11 11 11 11 11 11 0 0 0 0 0 11 11 0 0 0 0 0 0 0 0 0 0 12 0 0 0 0 0 0 0 0 12 
6 6 6 6 6 6 6 0 0 0 0 0 0 0 0 0 11 0 0 0 1 2 2 2 1 0 0 0 0 0 0 0 0 0 0 0 0 0 0 0 0 0 0 0 0 0 0 11 0 11 0 0 0 0 0 0 0 0 0 11 0 0 11 0 11 11 11 11 11 0 0 0 0 0 0 0 0 0 0 0 11 0 0 0 0 0 0 11 11 0 0 0 0 0 0 0 0 0 12 1 0 0 0 0 0 0 0 12 
6 6 6 6 6 6 6 6 0 0 0 0 0 0 0 0 11 0 11 11 11 11 11 11 11 11 11 0 0 0 11 11 11 11 11 11 11 11 11 11 11 11 11 11 11 0 0 0 11 0 0 0 0 0 0 11 11 11 11 11 0 0 11 0 0 0 0 0 11 0 0 0 0 0 0 0 0 0 0 0 11 0 0 0 0 0 0 11 0 0 0 0 0 0 0 0 0 0 12 12 12 12 12 12 0 0 0 12 
6 6 6 6 6 6 6 6 6 6 6 0 0 0 0 0 11 0 0 11 0 0 0 0 0 0 0 0 0 0 0 0 0 0 0 0 0 0 0 0 0 0 0 0 11 0 0 0 0 0 0 0 0 0 0 0 0 0 0 0 0 0 0 0 0 0 0 0 11 0 0 0 0 0 0 0 0 0 0 0 11 1 0 0 0 0 0 11 0 0 0 0 0 0 0 0 0 0 0 0 0 0 0 0 0 0 0 12 
0 0 0 0 0 0 0 0 0 0 0 0 0 0 0 0 11 0 0 11 0 0 0 11 11 11 11 11 11 11 11 11 11 11 11 11 11 11 11 11 11 11 0 0 11 0 0 0 0 0 0 0 0 1 0 0 0 0 0 0 0 11 11 0 0 0 0 0 11 0 0 0 0 0 0 0 0 0 0 0 11 1 1 0 0 0 0 11 11 11 11 11 11 11 11 11 0 0 0 0 0 0 0 0 0 0 0 12 
0 0 0 0 0 0 0 0 0 0 0 0 0 0 0 0 11 11 0 11 0 0 0 0 0 0 0 0 0 0 0 0 0 0 0 0 0 0 0 0 0 11 0 0 11 0 0 0 0 0 0 0 1 1 1 0 0 0 0 0 0 0 11 0 0 0 0 0 11 1 0 0 0 0 0 0 0 0 0 0 11 11 11 11 0 0 0 11 0 0 0 0 0 0 0 11 11 11 0 0 0 0 0 0 0 0 12 12 
0 0 0 0 0 0 0 0 0 0 0 0 0 0 0 0 11 0 0 11 0 0 0 0 0 0 0 0 0 0 0 0 0 0 0 0 0 0 0 0 0 11 0 0 11 11 11 11 0 0 0 11 11 11 11 11 11 11 11 0 0 0 11 0 0 0 0 0 11 1 1 0 0 0 0 0 0 0 0 0 0 0 0 11 11 0 0 11 0 0 0 0 0 0 0 0 0 11 11 
0 0 0 0 0 0 0 0 0 0 0 0 0 0 0 0 11 0 0 11 0 0 0 0 0 0 0 0 0 0 0 0 0 0 0 0 0 0 0 0 0 11 0 0 0 0 0 0 0 0 0 0 0 0 0 0 0 0 0 0 0 0 11 11 11 0 11 11 11 11 11 11 11 11 11 11 11 0 0 0 0 0 0 11 0 0 0 11 0 0 0 0 0 0 0 0 0 0 11 11 
0 0 0 0 0 0 0 0 0 0 0 0 0 0 0 0 11 0 11 11 11 11 11 11 11 11 11 11 11 11 11 11 11 11 11 11 11 11 11 0 0 11 0 0 0 0 0 0 0 0 0 0 0 0 0 0 0 0 0 0 0 1 11 0 0 0 0 0 0 0 0 0 0 0 0 0 0 0 0 0 0 0 0 11 0 0 0 11 0 0 0 0 0 0 0 0 0 0 0 11 11 11 11 
0 0 0 0 0 0 0 0 0 0 0 0 0 0 0 0 11 0 0 0 0 0 0 0 0 0 0 0 0 0 0 0 0 0 0 0 0 0 11 0 0 11 0 0 0 0 0 0 1 0 0 0 0 0 0 0 0 0 11 0 1 1 11 0 0 0 11 0 0 0 0 0 0 0 0 0 0 0 0 11 11 0 0 11 11 0 0 11 0 0 0 11 
0 0 0 0 0 0 0 0 0 0 0 0 0 0 0 0 11 0 0 0 0 0 0 0 0 0 0 0 0 0 0 0 0 0 0 0 0 0 11 0 0 11 0 0 0 0 0 11 11 11 11 11 11 11 11 11 0 0 11 11 11 11 11 0 0 0 11 0 0 0 0 0 0 0 0 0 0 0 11 11 0 0 11 11 0 0 0 11 11 11 11 11 11 11 11 11 11 0 0 0 0 0 0 0 0 0 12 12 
0 0 0 0 0 0 0 0 0 0 0 0 0 0 0 0 11 1 0 0 0 0 0 0 0 0 0 0 0 0 0 0 0 0 0 0 0 0 11 0 11 11 0 0 0 0 0 0 0 0 0 0 0 0 0 0 0 0 11 0 0 0 0 0 0 1 11 0 0 0 0 0 0 0 0 0 0 11 11 0 0 11 11 0 0 0 0 0 0 0 0 0 0 0 0 0 11 0 0 0 0 0 0 0 0 0 0 12 
0 0 0 0 0 0 0 0 0 0 0 0 0 0 0 0 11 1 1 0 0 0 0 0 0 0 0 0 0 0 0 0 0 0 0 0 0 0 11 0 0 0 0 0 0 0 0 0 0 0 0 0 0 0 0 0 0 0 11 0 0 0 0 0 1 1 11 0 0 0 0 0 0 0 0 0 11 11 0 0 11 11 0 0 11 11 11 0 0 0 0 0 0 0 0 0 11 11 0 0 0 11 11 0 0 0 0 12 
0 0 0 0 0 0 0 0 0 0 0 0 0 0 0 0 11 11 11 11 11 11 11 11 11 11 11 0 0 0 11 11 11 11 0 11 0 0 11 0 0 0 0 0 1 0 0 0 0 0 0 0 0 0 0 0 0 0 11 0 0 0 0 1 1 1 11 0 0 0 0 0 0 0 0 11 11 0 0 11 11 0 0 11 11 0 0 0 0 0 0 0 0 0 0 0 0 0 0 0 0 11 0 0 0 0 0 12 
0 0 0 0 0 0 0 0 0 0 0 0 0 0 0 0 11 0 0 0 0 0 0 0 0 0 0 0 0 0 0 1 0 0 0 11 0 0 11 11 0 11 11 0 11 11 11 11 11 11 11 11 11 11 11 11 11 11 11 0 0 11 11 11 11 11 11 11 11 0 0 11 11 11 11 11 0 0 11 11 0 0 11 11 0 0 0 0 0 0 0 0 0 0 0 0 0 0 0 0 0 11 0 0 12 0 0 12 
0 0 0 0 0 0 0 0 0 0 0 0 0 0 0 0 11 0 0 0 0 0 0 0 0 0 0 0 0 0 0 1 0 0 0 11 0 0 11 0 0 11 0 0 0 0 0 0 0 0 0 0 0 0 0 0 0 0 0 0 0 11 0 0 0 0 0 0 0 0 0 0 0 0 0 11 0 0 0 0 0 11 11 0 0 0 0 0 0 0 0 0 1 0 0 0 0 0 0 1 0 11 0 0 12 0 0 12 
0 0 0 0 0 0 0 0 0 0 0 0 0 0 0 0 11 0 0 0 0 0 0 0 0 0 0 0 0 0 0 1 0 0 0 11 11 0 11 0 0 11 0 0 0 0 0 0 0 0 0 0 0 0 0 0 0 0 0 0 0 11 0 0 0 0 0 0 0 0 0 0 0 0 0 11 11 11 11 11 11 11 0 0 0 0 0 11 11 11 11 11 11 11 0 0 11 11 11 11 11 11 12 12 12 0 0 12 
0 0 0 0 0 0 0 0 0 0 0 0 0 0 0 0 11 0 0 0 11 11 11 11 11 11 0 11 11 11 0 11 0 0 0 11 0 0 11 0 11 11 0 0 0 0 0 0 0 0 0 0 0 0 0 0 0 0 0 0 0 11 0 0 0 0 0 0 0 0 0 0 0 0 0 0 0 0 0 0 0 0 0 0 0 0 11 11 0 0 0 0 0 0 0 0 0 0 0 0 0 11 0 0 0 0 12 12 
0 0 0 0 0 0 0 0 0 0 0 0 0 0 0 0 11 0 0 0 11 0 0 0 0 0 0 0 0 0 0 11 0 0 0 11 0 0 11 0 0 11 11 11 11 11 0 0 0 11 11 11 11 11 11 11 11 11 11 11 11 11 0 0 0 0 0 0 0 1 1 0 0 0 0 0 0 0 0 0 0 0 0 0 0 11 11 0 0 0 0 0 0 0 0 0 0 0 0 0 0 11 0 0 0 0 12 12 
0 0 0 0 0 0 0 0 0 0 0 0 0 0 0 0 11 11 0 0 11 0 0 0 0 0 0 0 0 0 0 11 0 0 0 11 0 1 11 0 0 11 0 0 0 11 0 0 0 0 0 0 0 0 0 0 0 0 0 0 0 0 0 0 0 0 0 0 1 1 1 1 0 0 0 0 0 0 0 0 0 0 0 0 11 11 0 0 0 0 0 0 0 0 0 0 0 0 0 0 0 11 0 0 12 12 12 12 
0 0 0 0 0 0 0 0 0 0 0 0 0 0 0 0 11 0 0 0 11 0 0 0 0 0 0 0 0 0 0 11 0 0 0 0 0 1 11 11 0 11 0 0 0 11 0 0 0 0 0 0 0 0 0 0 0 0 0 0 0 0 0 0 11 11 11 11 11 11 11 11 11 11 11 11 11 11 0 0 0 0 0 11 11 0 0 0 0 0 0 11 11 11 11 11 11 0 0 0 0 11 12 0 12 0 0 12 
0 0 0 0 0 0 0 0 0 0 0 0 0 0 0 0 11 0 0 0 11 0 0 11 11 11 11 11 11 11 11 11 0 0 0 11 11 11 11 0 0 11 0 0 0 11 11 0 0 0 0 0 0 0 0 0 0 0 0 0 0 0 0 0 11 0 0 0 0 0 0 0 0 0 0 0 0 11 11 0 0 0 11 11 0 0 11 11 11 11 11 0 0 0 0 0 0 0 11 11 11 11 0 0 0 0 0 12 
0 0 0 0 0 0 0 0 0 0 0 0 0 0 0 0 11 0 0 11 11 0 0 11 0 0 0 11 0 0 0 11 0 0 0 11 0 0 0 0 0 11 0 0 0 11 0 0 0 0 0 0 0 0 0 0 0 0 0 0 0 0 0 0 11 0 0 0 0 0 0 0 0 0 11 11 0 0 11 11 0 11 11 0 0 0 11 0 0 0 0 0 0 0 0 0 0 0 0 0 0 12 0 0 0 0 0 12 
0 0 0 0 0 0 0 0 0 0 0 0 0 0 0 0 11 0 0 0 11 0 0 0 0 0 0 11 0 0 0 0 0 0 1 11 0 0 0 0 1 11 0 0 0 11 0 0 0 0 0 0 0 0 0 0 11 11 11 0 0 0 0 1 11 0 0 0 0 0 0 0 0 0 0 11 11 0 0 0 0 0 0 0 0 0 11 0 0 0 0 0 0 0 0 0 0 0 0 0 0 12 12 12 12 0 0 12 
0 0 0 0 0 0 0 0 0 0 0 0 0 0 0 0 11 0 0 0 11 1 0 0 0 0 0 0 0 0 0 0 0 1 1 11 0 0 11 11 11 11 0 0 0 11 0 0 0 11 11 11 11 11 11 0 0 0 0 0 11 11 11 11 11 0 0 11 0 0 0 0 11 0 0 0 11 11 0 0 0 0 0 0 0 0 11 0 0 0 12 12 12 12 12 12 12 12 12 0 0 0 0 0 0 0 0 12 
0 0 0 0 0 0 0 0 0 0 0 0 0 0 0 0 11 11 0 0 11 11 11 11 11 11 11 11 11 11 11 11 11 11 11 11 11 0 0 0 0 0 0 0 0 11 11 0 0 0 0 0 0 0 0 0 0 0 0 0 0 0 0 0 0 0 0 11 0 0 0 0 11 0 0 0 0 11 11 11 11 11 11 11 11 11 11 0 0 12 0 0 0 0 0 0 0 0 0 12 0 0 0 0 0 0 0 12 
0 0 0 0 0 0 0 0 0 0 0 0 0 0 0 0 0 0 0 0 0 0 0 0 0 0 0 0 0 0 0 0 0 0 0 0 0 0 0 0 0 0 0 0 0 0 0 0 0 0 0 0 0 0 0 0 0 0 0 0 0 0 0 0 0 0 0 11 0 0 0 0 11 0 0 0 0 0 0 0 0 0 0 0 0 0 0 0 12 0 0 0 0 0 0 0 0 0 0 0 12 0 0 0 0 0 12 12 
0 0 0 0 0 0 0 0 0 0 0 0 0 0 0 0 0 0 0 0 0 0 0 0 0 0 0 0 0 0 0 0 0 0 0 0 0 0 0 11 11 11 11 0 11 11 0 0 0 0 0 0 0 0 0 0 0 0 0 0 0 0 0 0 0 0 1 11 1 0 0 0 11 0 0 0 0 0 0 0 0 0 0 0 0 0 0 0 0 0 0 0 0 0 0 0 0 0 0 0 0 0 0 0 0 12 12 12 
4 4 4 4 4 4 4 4 4 4 4 4 4 4 0 0 11 11 11 11 11 11 11 11 11 11 11 11 11 11 11 11 11 11 11 11 11 11 11 11 11 11 11 11 11 11 11 11 11 11 11 11 11 11 11 11 0 0 0 11 11 11 11 11 11 11 11 11 11 11 11 11 11 11 11 11 11 12 12 12 12 12 12 12 12 12 12 12 12 12 12 12 12 12 12 12 12 12 12 12 12 12 12 12 12 12 12 12 
