8 32 32 32 32 32 0 0 0 0 0 0 0 0 0 0 0 0 0 0 0 0 0 0 0 0 0 0 0 0 0 0 0 0 0 0 0 0 0 0 0 0 0 8 8 8 8 8 8 8 8 8 8 8 8 8 8 8 8 8 8 8 8 8 8 8 0 0 0 0 0 0 0 0 0 0 0 0 0 0 0 0 0 0 0 0 0 0 0 0 0 0 0 0 0 0 0 0 0 0 0 0 0 0 0 0 0 0 0 0 0 0 0 8 
8 32 32 32 32 32 0 0 0 0 0 0 0 0 0 0 0 0 0 0 0 0 0 0 0 0 0 0 0 0 0 0 0 0 0 0 0 0 0 0 0 0 0 8 32 32 32 32 32 32 32 32 32 32 32 32 32 32 32 32 32 32 8 8 8 8 0 0 0 0 0 0 0 0 0 0 0 0 0 0 0 0 0 0 0 0 0 0 0 0 0 0 0 0 0 0 0 0 0 0 0 8 8 0 0 0 0 0 0 0 0 0 0 8 8 
8 32 32 32 32 32 0 0 0 0 0 0 0 0 0 0 0 0 0 0 0 0 0 7 0 0 0 0 0 0 0 0 0 0 0 0 0 0 0 0 0 0 0 8 32 32 32 32 32 32 32 32 32 32 32 32 32 32 32 32 32 32 32 8 8 8 0 0 0 0 0 0 0 0 0 0 0 0 0 0 0 0 0 0 0 0 0 0 0 8 8 8 0 0 0 0 0 0 0 8 8 8 8 32 8 0 0 0 0 0 0 0 32 32 8 
32 32 32 32 32 32 0 0 0 0 0 0 0 0 7 7 7 7 0 0 0 0 7 7 7 0 0 0 7 7 7 7 7 0 0 0 0 0 0 0 0 0 0 8 32 32 32 32 32 32 32 32 32 32 32 32 32 32 32 32 32 32 32 32 8 8 0 0 0 0 0 0 0 0 0 0 0 0 0 0 0 0 0 0 0 0 0 0 0 8 8 8 8 0 0 0 0 0 0 8 8 8 8 32 8 0 0 0 0 0 0 0 8 32 32 8 
32 32 32 32 32 32 0 0 0 0 0 0 0 0 0 0 0 0 0 0 0 0 0 0 0 0 0 0 0 0 0 0 0 0 0 0 0 0 0 0 0 0 0 8 8 8 8 8 8 8 8 8 8 8 8 32 32 32 8 8 8 32 32 32 32 8 8 0 0 0 0 8 8 8 0 0 0 0 0 0 0 0 0 0 0 0 0 0 0 8 8 8 8 0 0 0 0 0 8 8 8 32 32 32 8 0 0 0 0 0 0 8 8 32 32 8 
8 8 8 8 8 8 0 0 0 0 0 0 0 0 0 0 0 0 0 0 0 0 0 0 0 0 0 0 0 0 0 0 0 0 0 0 0 0 0 0 0 0 0 32 32 32 32 0 0 0 0 0 0 0 8 32 32 32 32 32 8 32 32 32 32 8 0 0 0 0 0 0 0 0 0 0 0 0 0 0 0 0 0 0 0 0 0 0 8 8 8 8 8 0 0 0 0 0 8 8 8 32 8 8 8 8 0 0 0 0 8 8 8 32 32 8 
8 8 8 8 8 8 8 0 0 0 0 0 0 0 0 0 0 0 0 0 0 0 0 0 0 0 0 0 0 0 0 0 0 0 0 3 0 0 0 0 0 0 0 32 32 32 32 0 0 0 0 0 0 0 8 32 32 32 32 32 8 32 32 32 32 8 0 0 0 0 0 0 0 0 0 0 0 0 0 0 0 0 0 0 0 0 0 0 8 8 8 8 8 0 0 0 0 0 8 32 32 32 32 32 32 8 0 0 0 0 8 32 32 32 3 8 
8 8 8 8 8 8 8 8 0 0 0 0 0 0 0 0 0 0 0 0 0 0 0 0 0 0 0 0 0 0 0 0 0 0 0 8 8 8 8 8 8 8 8 8 32 32 32 0 0 0 0 0 0 0 8 8 32 32 32 32 8 32 32 32 32 8 8 0 0 0 0 0 0 0 0 0 0 0 0 0 0 0 0 0 0 0 0 8 8 8 8 8 8 0 0 0 0 0 8 32 32 32 32 32 32 8 0 0 0 0 8 32 8 8 8 8 
8 8 8 8 8 8 8 8 8 0 0 0 0 0 0 0 0 0 0 0 0 0 0 0 0 0 0 0 0 0 0 0 0 0 0 8 8 8 8 8 8 8 8 8 32 32 32 0 0 0 0 0 0 0 8 32 32 32 32 32 8 32 32 32 32 8 0 0 0 0 0 0 0 0 0 0 0 0 0 0 0 0 0 0 0 0 8 8 8 8 8 8 8 0 0 0 0 0 8 32 32 32 32 32 32 8 0 0 0 0 8 32 32 32 32 8 
8 8 8 8 8 8 8 8 8 8 0 0 0 0 0 0 0 0 0 0 0 0 0 0 0 0 0 0 0 0 0 0 0 0 0 8 8 8 8 8 8 8 8 8 32 32 32 0 0 0 0 0 0 0 8 32 32 32 32 8 8 8 32 32 32 8 0 0 0 0 0 0 0 0 0 0 0 0 0 0 0 0 0 0 0 0 8 8 8 8 8 8 8 0 0 0 0 0 8 32 32 32 32 32 32 8 0 0 0 0 8 8 32 32 32 8 8 
8 8 8 8 8 8 8 8 8 8 8 0 0 0 0 0 0 0 0 0 0 0 0 0 0 0 0 0 0 0 0 0 0 0 8 8 8 8 8 8 8 8 8 8 8 8 32 0 0 0 0 0 0 0 8 32 32 32 32 32 8 32 32 32 32 8 8 0 0 0 0 0 0 0 0 0 0 0 0 0 0 0 0 0 0 0 8 8 8 8 8 8 8 0 0 0 0 0 8 8 8 8 32 8 8 8 0 0 0 0 8 8 8 32 32 8 8 8 
8 8 8 8 8 8 8 8 8 8 8 8 0 0 0 0 0 0 0 0 0 0 0 0 0 0 0 0 0 0 0 0 0 0 8 8 8 8 8 8 8 8 8 8 8 8 8 0 0 0 0 0 0 0 8 32 32 32 32 32 8 32 32 32 32 8 0 0 0 0 0 0 0 0 0 0 0 0 8 0 0 0 0 0 0 8 8 8 8 8 8 8 8 0 0 0 0 0 8 8 8 8 32 8 8 8 0 0 0 0 8 8 8 8 32 32 8 8 
8 8 8 8 8 8 8 8 8 8 8 8 32 0 0 0 0 0 0 0 0 0 0 0 0 0 0 0 0 0 0 0 0 0 8 8 8 8 8 8 8 8 8 8 8 8 32 0 0 0 0 0 0 0 8 32 8 32 8 32 8 32 32 32 8 8 0 0 0 0 0 0 0 0 0 0 0 8 8 0 0 0 0 0 0 8 8 8 8 8 8 8 8 0 0 0 0 0 8 32 32 32 32 32 32 8 0 0 0 8 8 32 32 32 32 32 8 8 
8 32 32 32 32 32 32 32 32 32 32 32 32 0 0 0 0 0 0 0 0 0 0 0 0 0 0 0 0 0 0 0 0 8 8 8 8 8 8 8 8 8 8 8 8 8 32 0 0 0 0 0 0 0 8 32 32 32 32 32 8 32 32 32 32 8 3 0 0 0 0 0 0 0 0 0 0 8 8 8 0 0 0 0 8 8 32 32 32 32 32 8 8 0 0 0 0 0 8 32 32 32 32 32 32 8 0 0 0 8 32 32 32 32 32 32 8 8 
8 32 32 8 8 8 8 8 8 8 8 8 8 0 0 0 0 0 0 0 0 0 0 0 0 0 0 0 0 0 0 0 0 8 8 8 8 8 8 8 8 8 8 8 8 8 32 0 0 8 0 0 0 0 8 32 32 32 32 32 8 32 32 32 32 8 3 3 0 0 0 0 0 0 0 0 8 8 8 8 0 0 0 0 8 8 32 32 32 32 32 8 8 0 0 0 0 0 8 32 32 32 32 32 32 8 0 0 0 8 32 32 32 32 32 3 8 8 0 0 0 8 8 8 8 8 8 8 
8 32 32 8 8 8 8 8 8 8 8 8 8 0 0 0 0 0 0 0 0 0 0 0 0 0 0 0 0 0 0 0 8 32 32 32 32 32 32 32 32 32 32 32 32 32 32 0 0 8 0 0 0 0 8 8 32 32 32 32 8 32 32 32 32 8 3 3 3 0 0 0 0 0 0 0 8 8 8 8 0 0 0 0 8 8 32 32 32 32 32 32 32 0 0 0 0 0 32 32 32 32 32 32 32 8 0 0 0 8 32 8 8 8 8 8 8 8 0 0 0 8 8 8 8 8 8 8 
8 32 32 8 8 8 8 8 8 8 8 8 8 0 0 0 0 0 0 0 0 0 0 0 0 0 0 0 0 0 0 0 8 32 32 32 32 32 32 32 32 32 32 32 8 8 8 32 32 32 0 0 0 0 8 8 8 32 32 32 8 32 8 8 32 8 28 28 28 0 0 0 0 0 0 0 8 8 8 8 0 0 0 0 8 8 32 8 8 8 8 8 8 27 27 27 27 27 8 8 8 8 8 8 8 8 0 0 0 8 32 32 32 32 32 32 8 8 0 0 0 8 8 8 8 8 8 8 
8 32 32 32 32 32 32 32 32 32 32 32 8 0 0 0 0 0 0 0 0 0 0 0 0 0 0 0 0 0 0 32 32 32 32 32 32 32 32 32 32 32 32 32 8 8 0 0 0 0 0 0 0 0 8 8 8 8 32 32 8 32 32 32 32 8 28 28 28 0 0 0 3 0 0 0 32 8 8 8 0 0 0 0 8 8 32 8 8 8 8 8 8 0 0 0 0 0 8 8 8 8 8 8 8 8 0 0 0 8 32 32 32 32 32 32 8 8 0 0 0 8 8 8 8 8 8 8 
8 8 32 32 32 32 32 32 32 32 32 32 8 0 0 0 0 0 0 0 0 0 0 0 0 0 0 0 0 0 0 32 32 32 32 32 32 32 32 32 32 32 32 32 32 8 0 0 0 0 0 0 0 0 8 32 32 32 32 32 8 32 32 32 32 8 28 28 28 0 0 3 3 0 0 0 32 32 8 8 0 0 0 8 32 32 32 8 8 8 8 8 8 0 0 0 0 0 8 8 8 8 8 8 32 0 0 0 0 8 3 32 32 32 32 32 32 32 0 0 0 8 8 8 8 8 8 8 
8 8 32 32 32 32 32 32 32 32 32 32 32 0 0 0 0 0 0 0 0 0 0 0 0 0 0 0 0 0 0 32 32 32 32 32 32 32 32 32 32 32 32 32 32 8 8 0 0 0 0 0 0 0 8 32 32 32 32 8 8 8 32 32 32 8 28 28 28 0 3 3 3 0 0 32 32 32 8 8 0 0 0 8 8 8 32 8 8 8 8 8 8 8 0 0 0 0 8 8 8 8 8 8 32 0 0 0 0 8 8 8 8 8 8 8 8 27 27 27 27 8 8 8 8 8 8 8 
8 8 32 8 8 8 8 8 8 8 8 8 8 8 0 0 0 0 0 0 0 0 0 0 0 0 0 0 0 0 8 8 8 8 32 32 8 32 32 32 8 32 32 8 32 8 0 0 0 0 0 0 0 0 8 32 32 32 8 8 8 8 8 32 32 8 3 28 28 0 28 28 28 0 0 32 32 32 32 8 0 0 0 8 8 8 32 8 8 8 8 8 8 0 0 0 0 0 8 8 8 8 32 32 32 
8 8 32 32 8 8 8 8 8 8 8 8 8 8 8 0 0 0 0 8 8 8 32 8 0 0 0 0 0 0 8 8 8 8 32 32 8 32 32 32 32 32 32 32 32 8 0 0 0 0 0 0 0 0 8 32 32 8 8 8 8 8 8 8 32 8 3 3 28 0 28 28 28 0 0 32 32 32 32 8 0 0 0 8 8 8 32 8 8 8 8 8 8 0 0 0 0 0 8 8 8 32 32 32 32 
8 8 8 32 32 8 8 8 8 8 8 8 8 8 8 0 0 0 0 8 8 8 32 8 0 0 0 0 0 0 8 8 8 8 32 8 8 8 32 32 32 32 32 32 32 8 8 0 0 0 0 0 0 0 8 32 32 32 32 32 8 32 32 32 32 8 27 27 27 27 27 27 27 27 27 8 8 32 32 8 0 0 0 8 8 32 32 32 8 8 8 8 8 8 0 0 0 0 8 8 32 32 32 32 32 
8 8 8 8 32 32 32 32 32 32 32 32 32 8 8 0 0 0 0 8 32 32 32 8 0 0 0 0 0 0 8 8 8 32 32 8 8 8 32 32 32 32 32 32 32 8 0 0 0 0 0 0 0 0 8 32 32 32 32 32 8 32 32 32 32 8 0 0 0 0 0 0 0 0 0 8 32 32 8 8 0 0 0 8 8 8 8 32 32 8 8 8 8 0 0 0 0 0 8 32 32 32 8 8 32 0 0 0 0 0 0 0 27 27 27 27 27 27 27 27 27 27 27 27 27 27 27 8 8 
8 8 8 8 8 8 8 8 8 8 8 8 8 8 8 0 0 0 0 8 32 8 8 8 0 0 0 0 0 0 8 8 8 32 32 8 8 8 8 32 32 32 32 32 32 8 0 0 0 0 0 0 0 0 8 8 32 32 32 32 8 32 32 32 32 8 0 0 0 0 0 0 0 0 0 8 32 32 32 8 0 0 0 8 8 8 8 32 32 32 8 8 8 0 0 0 0 0 8 32 32 8 8 8 8 0 0 0 0 0 0 0 8 8 0 0 0 0 0 0 0 0 0 0 0 8 8 8 8 8 
8 32 32 32 32 32 32 32 32 32 32 32 8 8 8 0 0 0 0 8 32 32 8 8 0 0 0 0 0 0 8 8 8 32 8 8 8 8 8 32 32 32 32 32 32 8 8 0 0 0 0 0 0 0 8 8 8 32 32 32 8 8 32 32 32 8 0 0 0 0 0 0 0 0 0 8 32 32 32 8 0 0 0 8 8 8 8 8 32 32 32 8 8 8 0 0 0 0 8 32 8 8 8 8 8 0 0 0 0 0 0 8 8 8 0 0 0 0 0 0 0 0 0 0 0 8 8 8 8 8 8 
8 32 32 32 32 32 32 32 32 32 32 32 32 8 8 0 0 0 0 8 8 32 32 8 0 0 0 0 0 0 32 32 32 32 8 8 8 8 8 8 32 32 32 32 32 8 0 0 0 0 0 0 0 0 8 8 8 8 32 32 8 8 8 32 32 32 0 0 0 0 0 0 0 0 0 8 8 32 32 32 8 0 0 8 8 8 8 8 32 32 32 32 8 0 0 0 0 0 8 32 32 32 8 8 0 0 0 0 0 0 8 8 8 8 0 0 0 0 0 0 0 0 0 0 0 8 8 8 8 8 8 8 
8 32 8 8 8 8 8 8 8 8 32 32 32 32 8 0 0 0 0 8 8 8 32 8 0 0 0 0 0 0 32 32 32 32 8 32 32 32 8 8 32 32 32 32 32 32 0 0 0 0 0 0 0 0 32 32 32 32 32 32 8 8 8 8 32 32 0 0 0 0 0 0 0 0 0 8 8 8 32 32 8 0 0 8 32 8 8 8 8 32 32 32 8 0 0 0 0 0 8 32 32 32 32 8 0 0 0 0 0 0 8 32 32 32 0 0 0 0 0 0 0 0 0 0 0 8 32 32 32 32 32 32 32 
8 32 8 8 8 8 8 8 8 8 8 32 32 32 32 0 0 0 0 8 8 8 32 8 0 0 0 0 0 8 8 8 8 8 8 32 32 32 8 8 8 8 8 8 8 8 27 27 27 27 27 27 27 27 27 8 8 8 8 8 8 8 8 8 8 8 0 0 0 0 0 0 0 0 0 8 8 8 32 32 8 0 0 8 32 32 32 32 32 32 32 32 8 8 0 0 0 0 8 8 32 32 32 8 0 0 0 0 0 0 8 32 32 32 0 0 0 0 0 0 0 0 0 0 0 8 32 32 32 8 8 8 8 
8 32 32 32 32 32 32 32 32 8 8 8 32 32 32 0 0 0 0 8 8 8 32 8 0 0 0 0 0 8 8 8 8 8 8 8 8 8 8 8 8 8 8 8 8 8 32 32 32 32 32 32 32 32 32 32 32 32 32 32 32 32 32 32 32 32 0 0 0 0 0 0 0 0 0 8 8 8 32 8 8 0 0 8 8 32 32 32 32 32 32 32 8 0 0 0 0 0 8 8 8 32 32 8 0 0 0 0 0 0 8 32 32 32 0 0 0 0 0 0 0 0 0 0 0 8 32 32 32 8 8 8 8 
8 32 32 32 32 32 32 32 32 8 8 8 8 32 32 0 0 0 0 32 32 32 32 8 0 0 0 0 0 8 8 8 8 8 8 32 32 32 32 32 32 8 8 8 8 8 32 32 32 32 32 32 32 32 32 32 32 32 32 32 32 32 32 32 32 32 0 0 0 0 0 0 0 0 0 8 8 8 32 32 8 0 0 8 8 32 32 8 8 8 32 8 8 0 0 0 0 0 8 8 8 8 32 8 0 0 0 0 0 0 8 8 8 8 27 27 27 27 27 0 0 0 0 0 0 8 32 32 32 8 8 8 8 
8 8 32 8 8 32 8 8 32 8 8 8 8 8 8 27 27 27 27 8 32 32 8 8 0 0 0 0 8 8 8 8 8 8 32 32 32 32 32 32 32 32 8 8 8 8 8 8 32 32 32 32 32 32 32 32 32 32 32 32 32 32 32 8 8 8 0 0 0 0 0 0 0 0 8 8 8 8 8 32 8 0 0 0 8 32 32 32 32 32 32 8 8 8 0 0 0 0 8 8 8 32 32 8 0 0 0 0 0 0 8 8 8 8 0 0 0 0 32 0 0 0 0 0 0 8 32 32 32 8 8 8 8 
8 8 32 8 8 32 8 8 32 8 8 8 8 8 8 0 0 0 0 8 32 32 8 8 0 0 0 0 8 8 8 8 8 32 32 32 32 32 32 32 32 32 32 8 8 8 8 8 8 32 32 32 32 32 32 32 32 32 32 32 32 32 8 8 8 8 0 0 0 0 0 0 0 0 8 8 32 32 32 32 8 0 0 0 8 8 8 32 32 32 32 8 8 0 0 0 0 0 8 8 32 32 32 8 0 0 0 0 0 0 8 8 8 8 0 0 0 0 32 0 0 0 0 0 8 8 32 32 32 32 32 32 8 
8 8 32 8 8 32 8 8 32 8 8 8 8 8 8 0 0 0 0 8 8 8 8 8 0 0 0 8 8 8 8 8 32 32 32 32 32 32 32 32 32 32 32 32 8 8 8 8 8 8 32 32 32 32 32 32 32 32 32 32 32 8 8 8 8 8 0 0 0 0 0 0 0 0 8 8 32 32 32 32 8 0 0 0 8 8 8 8 32 32 8 8 8 0 0 0 0 32 8 32 32 32 8 8 0 0 0 0 0 0 8 8 8 8 0 0 0 0 32 0 0 0 0 0 8 8 8 32 32 32 32 32 8 
8 8 32 8 8 32 8 8 32 8 8 8 8 8 8 0 0 0 0 8 8 8 8 8 0 0 0 8 8 8 8 32 32 32 32 32 32 32 32 32 32 32 32 32 32 8 8 8 8 8 8 32 32 32 32 32 32 32 32 32 8 8 8 8 8 8 0 0 0 0 0 0 0 0 8 8 32 32 32 8 8 0 0 0 8 8 8 32 32 32 32 32 8 8 0 0 32 32 32 32 32 8 8 8 0 0 0 0 0 0 8 8 8 8 0 0 0 0 32 0 0 0 0 8 8 8 8 8 32 8 8 8 8 
8 8 32 8 8 32 8 8 32 32 32 32 32 32 8 0 0 0 0 8 32 32 32 8 0 0 0 8 8 8 8 32 32 32 32 32 8 8 32 32 32 32 32 32 32 32 8 8 8 8 8 8 32 32 32 32 32 32 32 8 8 8 8 8 8 8 0 0 0 0 0 0 0 0 8 8 32 32 8 8 8 0 0 0 8 32 32 32 32 32 8 8 8 8 0 32 32 32 32 32 8 8 8 8 0 0 0 0 0 0 8 32 32 8 0 0 0 0 32 0 0 0 0 8 8 8 32 32 32 32 32 32 8 8 
8 32 32 8 8 32 8 8 8 8 8 8 8 8 8 0 0 0 0 32 32 32 32 32 0 0 8 8 8 8 8 32 32 32 32 8 8 8 8 32 32 32 32 32 32 32 32 8 8 8 8 8 8 8 32 32 32 32 8 8 8 8 8 8 8 8 0 0 0 0 0 0 0 0 8 8 32 8 8 8 8 0 0 0 8 8 32 32 32 32 32 8 8 8 8 32 32 32 32 8 8 8 8 8 0 0 0 0 0 0 8 8 32 8 0 0 0 0 32 0 0 0 0 8 8 8 32 32 32 32 32 8 8 8 
8 32 8 8 8 32 32 32 32 32 32 32 32 32 32 0 0 0 0 8 32 32 32 8 0 0 8 8 8 8 8 32 32 32 8 8 8 8 8 8 32 32 32 32 32 32 32 32 32 32 32 32 32 32 32 32 32 8 8 8 8 8 8 8 8 8 0 0 0 0 0 0 0 0 8 8 32 32 32 32 8 0 0 0 8 8 8 32 32 32 8 8 8 8 8 32 32 32 8 8 8 8 8 8 0 0 0 0 0 0 8 8 32 8 0 0 0 0 32 0 0 0 8 8 8 8 8 32 32 32 8 8 8 8 0 0 0 0 0 0 0 0 0 0 0 0 0 0 0 0 0 0 0 0 0 0 0 0 0 0 0 0 0 0 0 0 0 0 0 0 0 0 0 0 0 0 0 0 0 0 0 0 0 0 0 0 0 0 0 0 0 0 0 0 0 0 0 0 0 0 0 0 0 0 0 0 0 0 0 0 0 0 0 0 0 0 0 0 0 0 0 0 0 0 0 0 0 0 0 0 0 0 0 0 0 0 0 0 0 0 0 0 0 0 0 31 31 31 7 7 7 
8 32 8 8 8 8 8 8 8 8 8 8 8 8 8 27 27 27 27 8 8 8 8 8 0 0 8 8 8 8 8 8 32 8 8 8 8 8 8 8 8 8 8 8 8 8 8 8 8 8 8 8 8 8 8 8 8 8 8 8 8 8 8 8 8 8 0 0 0 0 0 0 0 8 8 8 32 32 32 32 8 0 0 0 8 8 8 8 32 32 32 8 8 8 8 32 32 32 32 32 8 8 8 8 0 0 0 0 0 0 8 32 32 8 0 0 0 0 32 0 0 0 8 32 32 8 8 32 32 32 32 32 32 8 8 0 0 0 0 0 0 0 0 0 0 0 0 0 0 0 0 0 0 0 0 0 0 0 0 0 0 0 0 0 0 0 0 0 0 0 0 0 0 0 0 0 0 0 0 0 0 0 0 0 0 0 0 0 0 0 0 0 0 0 0 0 0 0 0 0 0 0 0 0 0 0 0 0 0 0 0 0 0 0 0 0 0 0 0 0 0 0 0 0 0 0 0 0 0 0 0 0 0 0 0 0 0 0 0 0 0 0 0 0 0 31 31 31 31 31 
8 32 32 32 32 32 32 32 32 32 32 32 32 32 8 0 0 0 0 8 8 8 8 8 0 8 8 8 8 8 8 8 32 8 8 8 8 8 8 8 8 8 8 8 8 8 8 8 8 32 8 32 8 32 8 32 8 32 8 32 8 32 8 32 8 8 0 0 0 0 0 0 8 8 8 8 8 32 32 32 8 0 0 0 8 8 8 32 32 32 32 32 32 8 8 8 8 32 32 32 32 32 32 8 0 0 0 0 0 0 8 32 8 8 0 0 0 0 32 0 0 0 8 32 32 32 32 8 32 32 32 32 32 32 8 0 0 0 0 0 0 0 0 0 0 0 0 0 0 0 0 0 0 0 0 0 0 0 0 0 0 0 0 0 0 0 0 0 0 0 0 0 0 0 0 0 0 0 0 0 0 0 0 0 0 0 0 0 0 0 0 0 0 0 0 0 0 0 0 0 0 0 0 0 0 0 0 0 0 0 0 0 0 0 0 0 0 0 0 0 0 0 0 0 0 0 0 0 0 0 0 0 0 0 0 0 0 0 0 0 0 0 0 0 0 31 31 31 31 31 
8 32 32 32 32 32 32 32 32 32 32 32 32 32 8 0 0 0 0 8 8 8 8 8 0 8 8 8 8 8 8 8 32 8 8 8 8 8 8 8 8 8 8 8 8 8 32 32 32 32 32 32 32 32 32 32 32 32 32 32 32 32 32 32 32 32 0 0 0 0 0 0 8 8 8 8 8 8 32 32 8 0 0 0 8 8 32 32 32 32 8 8 32 8 8 8 8 32 32 32 32 32 32 8 0 0 0 0 0 0 8 32 8 8 0 0 0 0 32 0 8 8 8 32 32 32 32 32 8 32 32 32 32 32 8 0 0 0 0 0 0 0 0 0 0 0 0 0 0 0 0 0 0 0 0 0 0 0 0 0 0 0 0 0 0 0 0 7 7 7 7 7 7 0 0 0 0 0 0 0 0 0 0 0 0 0 0 0 0 0 0 0 0 0 0 0 0 0 0 0 0 0 0 0 0 0 0 0 0 0 0 0 0 0 0 0 0 0 0 0 0 0 0 0 0 0 0 0 0 0 0 0 0 0 0 0 0 0 0 0 0 0 0 0 0 7 31 31 31 31 
8 8 8 8 8 8 8 8 8 8 8 8 8 8 8 0 0 0 0 8 32 8 8 8 0 8 8 8 8 8 8 8 32 8 8 8 8 8 8 8 8 8 8 8 8 32 32 32 32 32 32 32 32 32 32 32 32 32 32 32 32 32 32 32 32 32 0 0 0 0 0 0 8 8 8 8 32 32 32 8 8 0 0 0 8 32 32 32 32 8 8 8 8 32 8 8 8 8 32 32 32 32 32 8 0 0 0 0 0 0 8 32 32 8 0 0 0 0 32 0 8 32 32 32 32 32 32 32 32 32 8 8 32 32 8 0 0 0 0 0 0 0 0 0 0 0 0 0 0 0 0 0 0 0 0 0 0 0 0 0 0 0 0 7 7 7 7 7 7 7 7 7 7 7 0 0 0 0 0 0 0 0 0 0 0 0 0 0 0 0 0 0 0 0 0 0 0 0 0 0 0 0 0 0 0 0 0 0 0 0 0 0 0 0 0 0 0 0 0 0 0 0 0 0 0 0 0 0 0 0 0 0 0 0 0 0 0 0 0 0 0 0 0 0 0 7 7 31 31 31 
8 8 8 8 8 8 8 8 8 8 8 8 8 8 8 0 0 0 0 8 32 8 8 8 0 8 8 8 32 32 32 32 32 32 32 32 32 32 8 8 8 8 8 8 32 32 32 32 32 32 32 32 32 32 32 32 32 32 32 32 32 32 32 32 32 32 0 0 0 0 0 0 8 8 8 8 32 32 32 8 0 0 0 0 8 32 32 32 32 32 8 8 32 32 8 8 8 8 8 32 32 32 32 8 0 0 0 0 0 0 8 8 32 8 0 0 0 0 32 8 32 32 32 32 32 32 32 32 32 32 32 32 8 8 8 8 0 0 0 0 0 0 0 0 0 0 0 0 0 0 0 0 0 0 0 0 0 0 0 0 0 0 7 7 7 7 7 7 7 7 7 7 7 7 31 7 0 0 0 0 0 7 0 0 0 0 0 7 0 0 0 0 7 0 0 7 0 0 7 0 0 0 0 0 0 0 0 0 0 0 0 0 0 0 0 0 0 0 0 0 0 0 0 0 0 0 0 0 0 0 0 0 0 0 0 0 0 0 0 0 0 0 0 0 0 31 31 31 31 31 
8 8 8 8 8 8 8 8 8 8 8 8 8 8 8 0 0 0 0 8 32 32 8 8 0 8 8 8 32 32 8 8 8 8 8 8 8 32 8 8 8 8 8 32 32 32 32 32 32 32 32 32 32 32 32 32 32 32 32 32 32 32 32 32 32 32 0 0 0 0 0 8 8 8 8 8 32 32 8 8 0 0 0 0 8 8 32 32 32 32 32 32 32 32 32 32 32 8 8 32 32 32 32 8 0 0 0 0 0 0 8 8 32 8 0 0 0 0 32 8 32 32 32 32 32 32 32 8 8 32 32 32 32 32 32 8 0 0 0 0 0 0 0 0 0 0 0 0 0 0 0 0 0 0 0 0 0 0 0 0 0 7 7 31 31 31 31 31 31 31 31 31 31 31 31 31 7 0 0 0 0 31 0 0 0 0 0 31 0 0 0 0 31 0 0 31 0 0 31 0 0 0 0 0 7 0 0 0 0 0 0 7 7 0 0 0 0 0 0 0 0 0 0 0 0 0 0 0 0 0 0 0 0 0 0 0 0 0 0 0 0 0 0 0 0 31 31 31 31 31 0 0 0 0 0 0 7 7 7 7 7 7 
8 8 8 8 8 8 8 8 8 8 8 8 8 8 8 0 0 0 0 8 8 32 8 8 0 8 8 8 32 8 8 8 8 8 8 8 8 32 8 8 8 8 32 32 32 32 32 32 32 32 32 32 32 32 32 32 32 32 32 32 32 32 32 32 32 32 0 0 0 0 0 8 8 8 8 8 32 8 8 8 0 0 0 0 0 0 8 8 32 32 32 32 32 32 32 32 32 8 8 8 32 32 32 8 0 0 0 0 0 0 8 32 32 8 0 0 0 0 32 8 32 32 32 32 32 8 8 32 32 8 8 32 32 32 32 8 0 0 0 0 0 0 0 0 0 0 0 0 0 0 0 0 0 0 0 0 0 0 0 7 7 7 7 31 7 7 7 7 7 7 7 7 7 7 7 7 7 2 0 0 0 31 0 0 0 0 0 31 0 0 0 0 31 0 0 31 0 0 31 0 0 0 0 0 7 0 0 0 0 0 7 7 7 7 0 0 0 0 0 7 0 0 7 7 7 0 0 0 0 0 0 0 0 0 0 0 7 0 0 0 0 0 0 0 0 31 31 31 7 7 0 0 0 0 0 0 7 7 7 7 7 7 
8 8 8 8 8 8 32 32 32 32 32 32 8 8 8 0 0 0 0 8 32 32 8 8 0 8 8 8 32 8 8 8 8 8 8 8 8 32 8 8 32 32 32 32 32 32 32 32 32 7 32 32 32 32 7 32 32 32 32 7 32 32 32 32 7 32 0 0 0 0 0 8 8 8 8 8 32 32 32 8 0 0 0 0 0 0 0 0 8 8 32 32 32 32 32 32 32 32 8 8 8 32 32 8 0 0 0 0 0 0 8 32 8 8 0 0 0 0 8 8 32 32 32 32 32 32 32 8 8 32 32 32 32 32 32 8 0 0 0 0 0 0 0 0 0 0 0 0 0 0 0 0 0 0 0 0 0 0 0 7 7 7 7 31 31 31 31 31 31 31 31 31 31 31 31 31 7 2 2 0 0 31 0 0 0 0 0 31 0 0 0 0 31 0 0 31 0 0 31 0 0 0 0 0 31 0 0 0 0 0 31 31 31 31 0 0 0 0 0 31 0 0 7 7 7 0 0 0 0 0 0 0 0 0 0 7 7 7 0 0 0 0 0 0 0 31 7 7 7 7 0 0 0 0 0 0 7 7 7 7 7 7 
8 32 32 32 32 8 32 32 8 8 32 32 8 32 32 0 0 0 0 8 32 8 8 8 0 8 8 8 32 8 8 8 8 8 8 8 8 32 8 32 32 32 32 32 32 32 32 32 32 7 32 32 32 32 7 32 32 32 32 7 32 32 32 32 7 32 0 0 0 0 0 8 8 8 8 8 8 32 32 8 0 0 0 0 0 0 0 0 0 0 8 8 32 32 32 32 32 32 32 8 8 8 32 8 0 0 0 0 0 0 8 32 32 8 0 0 0 0 8 32 32 32 32 32 32 32 32 8 8 32 32 32 32 32 32 32 0 0 0 0 0 0 0 0 0 0 0 0 0 0 0 0 0 0 0 0 7 7 7 7 7 7 7 7 7 7 7 7 7 7 7 7 7 7 7 31 7 7 7 7 7 7 7 7 7 7 7 7 7 7 7 7 7 7 7 7 7 7 7 0 0 0 0 0 31 0 0 0 0 0 31 31 31 31 0 0 0 0 0 31 0 0 7 7 7 0 0 0 0 0 0 0 0 0 7 7 31 7 7 0 0 0 0 0 0 7 7 7 7 7 0 0 0 0 0 0 7 7 7 7 7 7 
8 32 32 32 32 32 32 32 32 32 32 32 32 32 32 0 0 0 0 8 32 32 8 8 0 32 32 32 3 32 32 32 32 32 32 32 32 32 32 32 32 32 32 32 32 32 32 32 32 32 32 32 32 32 32 32 32 32 32 32 32 32 32 32 7 32 0 0 0 0 32 32 32 32 32 32 32 32 32 32 0 0 0 0 0 0 0 0 0 0 0 0 8 8 32 32 32 32 32 32 32 32 32 8 0 0 0 0 0 0 8 8 32 8 0 0 0 0 32 32 32 32 7 7 32 32 32 32 32 32 32 32 32 32 32 32 0 0 0 7 7 7 0 0 0 0 0 0 0 0 7 7 7 7 7 7 7 7 7 31 31 31 31 31 31 31 31 31 31 31 31 31 31 31 31 31 7 7 7 7 7 7 7 7 7 7 7 7 7 7 7 7 7 7 7 7 7 7 7 2 0 0 0 0 31 0 0 0 0 0 31 31 31 31 0 0 0 0 0 31 0 0 7 7 7 7 0 0 0 0 0 0 0 0 31 31 31 31 31 0 0 0 0 0 0 31 31 31 31 31 0 0 0 0 0 0 7 7 7 7 7 7 
8 32 32 32 32 32 32 32 32 32 32 32 32 32 32 0 0 0 0 32 32 32 32 32 0 32 32 32 32 32 32 32 32 32 32 32 32 3 32 32 32 32 32 32 32 3 32 32 32 32 32 32 32 32 32 32 32 32 32 32 32 32 32 32 7 32 0 0 0 0 8 8 8 8 8 8 8 8 8 8 0 0 0 0 0 0 0 0 0 0 0 0 0 0 8 8 8 32 32 32 32 32 32 32 0 0 0 0 0 0 32 32 32 8 3 0 0 0 32 32 32 7 7 7 7 7 32 32 32 32 32 7 7 7 7 32 0 0 7 7 7 7 33 33 33 33 33 7 7 7 7 7 7 7 7 7 7 7 7 31 31 31 31 31 31 31 31 31 31 31 31 31 31 31 31 3 7 7 7 7 7 7 7 7 7 7 7 7 7 7 7 7 7 7 7 7 7 7 7 2 2 0 0 0 31 0 0 0 0 0 31 31 31 31 0 0 0 0 0 31 0 0 7 7 7 7 0 0 0 0 0 0 0 0 31 31 31 31 31 0 0 0 0 0 0 31 31 31 31 31 0 0 0 0 0 0 7 7 7 7 7 7 
7 7 7 7 7 7 7 7 7 7 7 7 7 7 7 7 7 7 7 7 7 7 7 7 7 7 7 7 7 7 7 7 7 7 7 7 7 7 7 7 7 7 7 7 7 7 7 7 7 7 7 7 7 7 7 7 7 7 7 7 7 7 7 7 7 7 7 7 7 7 7 7 7 7 7 7 7 7 7 7 7 7 7 7 7 7 7 7 7 7 7 7 7 7 7 8 8 8 8 8 8 8 8 8 7 7 7 7 7 7 7 7 7 7 7 7 7 7 7 7 7 7 7 7 7 7 7 7 7 7 7 7 7 7 7 7 7 7 7 7 7 7 33 33 33 33 33 7 7 7 7 7 7 7 7 7 7 7 7 7 7 7 7 7 7 7 7 7 7 7 7 7 7 7 7 7 7 7 7 7 7 7 7 7 7 7 7 7 7 7 7 7 7 7 7 7 7 7 7 7 7 7 7 7 7 7 7 7 7 7 7 7 7 7 7 7 7 7 7 7 7 7 7 7 7 7 7 7 7 7 7 7 7 7 7 7 7 7 7 7 7 7 7 7 7 7 7 7 7 7 7 7 7 7 7 7 7 7 7 7 7 7 
