0 
0 
0 
0 
10 10 10 10 10 10 10 0 0 0 0 27 27 27 27 27 27 27 27 27 27 27 27 0 0 0 0 0 0 0 0 0 0 0 0 0 0 0 0 0 27 27 27 27 27 27 27 27 0 0 0 0 0 0 0 0 0 0 0 0 0 0 27 
0 0 0 0 0 0 0 0 0 0 0 0 13 0 0 0 0 31 31 0 0 0 27 0 0 0 0 0 0 0 0 0 0 0 0 0 0 0 0 0 27 0 0 0 0 0 0 27 0 0 0 0 0 0 0 0 0 0 0 0 0 0 27 0 0 0 0 27 
0 0 0 0 0 0 0 0 0 0 0 0 13 0 0 0 0 31 31 0 0 0 27 0 0 0 0 0 0 0 0 0 0 0 0 0 0 0 0 0 27 0 0 0 0 0 0 27 0 0 0 0 0 0 0 0 0 0 0 0 0 0 27 0 0 0 0 27 27 
0 0 0 0 0 0 0 0 0 0 0 0 13 0 0 0 0 31 31 0 0 0 27 27 0 0 0 0 0 0 0 0 0 0 0 0 0 0 0 0 27 0 0 0 0 0 0 27 27 0 0 0 0 0 0 0 0 0 0 0 0 0 27 0 0 0 0 0 27 27 
0 0 0 0 0 0 0 0 0 0 0 0 13 0 0 0 0 31 31 0 0 0 27 0 0 0 0 0 0 0 0 0 0 0 0 0 0 0 0 0 27 0 0 0 0 0 0 27 0 0 0 0 0 0 0 0 0 0 0 0 0 0 27 0 0 0 0 0 0 27 27 
0 0 0 0 0 0 0 0 0 0 0 0 13 0 0 0 0 31 31 0 0 0 27 0 0 0 0 0 0 0 0 0 0 0 0 0 0 0 0 0 27 0 0 0 0 0 0 27 0 0 0 0 0 0 0 0 0 0 0 0 0 0 27 0 0 0 0 0 0 0 27 27 0 0 0 0 0 0 0 0 0 0 0 0 0 0 0 0 0 0 0 0 0 0 0 0 0 0 0 0 0 0 0 0 0 0 0 0 0 0 0 0 0 0 0 0 0 0 0 0 0 0 0 0 0 0 0 0 0 0 0 0 27 27 27 27 
0 0 0 0 0 0 0 0 0 0 0 0 13 0 0 0 0 31 31 0 0 0 27 27 27 27 27 27 27 27 27 27 27 27 27 27 27 27 27 27 27 0 0 0 0 0 0 27 27 27 27 27 27 27 27 27 27 27 27 27 27 27 27 0 0 0 0 0 0 0 0 27 27 0 0 0 0 0 0 0 0 0 0 0 0 0 0 0 0 0 0 0 0 0 0 0 0 0 0 0 0 0 0 0 0 0 0 0 0 0 0 0 0 0 0 0 0 0 0 0 0 0 0 0 0 0 0 0 0 0 0 0 30 30 30 30 
0 0 0 0 0 0 0 0 0 0 0 0 13 0 0 0 0 31 31 0 0 0 0 0 0 0 0 0 0 0 0 0 0 0 0 0 0 0 0 0 0 0 0 0 0 0 0 0 0 0 0 0 0 0 0 0 0 0 0 0 0 0 0 0 0 0 0 0 0 0 0 0 27 27 0 0 0 0 0 0 0 0 0 0 0 0 0 0 0 0 0 0 0 0 0 0 0 0 0 0 0 0 0 0 0 0 0 0 0 0 0 0 0 0 0 0 0 0 0 0 0 0 0 0 0 0 0 0 0 0 0 0 27 27 27 27 
0 0 0 0 0 0 0 0 0 0 0 0 13 0 0 0 0 31 31 0 0 0 0 0 0 0 0 0 0 0 0 0 0 0 0 0 0 0 0 0 0 0 0 0 0 0 0 0 0 0 0 0 0 0 0 0 0 0 0 0 0 0 0 0 0 0 0 0 0 0 0 0 0 27 27 0 0 0 0 0 0 0 0 0 0 0 0 0 0 0 0 0 0 0 0 0 0 0 0 0 0 0 0 0 0 0 0 0 0 0 0 0 0 0 0 0 0 0 0 0 0 0 0 0 0 0 0 0 0 0 0 0 30 30 30 30 
0 0 0 0 0 0 0 0 0 0 0 0 13 0 0 0 0 31 31 0 0 0 0 0 0 0 0 0 0 0 0 0 0 0 0 0 27 27 27 27 0 0 0 0 27 27 27 27 0 0 0 0 27 27 27 27 0 0 0 0 27 27 27 27 0 0 0 0 0 0 0 0 0 0 27 27 0 0 0 0 0 0 0 0 0 0 0 0 0 0 0 0 0 0 0 0 0 0 0 0 0 0 0 0 0 0 0 0 0 0 0 0 0 0 0 0 0 0 0 0 0 0 0 0 0 0 0 0 0 0 0 0 30 30 30 30 
0 0 0 0 0 0 0 0 0 0 0 0 13 0 0 0 0 31 31 0 0 0 0 0 0 0 0 0 0 0 0 0 27 27 27 27 0 31 31 0 27 27 27 27 0 31 31 0 27 27 27 27 0 31 31 0 27 27 27 27 0 0 0 0 27 27 27 27 0 0 0 0 0 0 0 27 27 0 0 0 0 0 0 0 0 0 0 0 0 0 0 0 0 0 0 0 0 0 0 0 0 0 0 0 0 0 0 0 0 0 0 0 0 0 0 0 0 0 0 0 0 0 0 0 0 0 0 0 0 0 0 0 27 27 27 27 
0 0 0 13 0 0 0 0 0 0 13 13 13 0 0 0 0 31 31 0 27 27 27 27 0 0 0 0 27 27 27 27 0 31 31 0 0 31 31 0 0 31 31 0 0 31 31 0 0 31 31 0 0 31 31 0 0 31 31 0 0 0 0 0 31 0 0 31 0 0 0 0 0 0 0 0 27 27 0 0 0 0 0 0 0 0 0 0 0 0 0 0 0 0 0 0 0 0 0 0 0 0 0 0 0 0 0 0 0 0 0 0 0 0 0 0 0 0 0 0 0 0 0 0 0 0 0 0 0 0 0 0 30 30 30 30 
0 0 13 13 13 0 0 0 0 0 0 0 0 0 0 0 0 31 31 0 0 31 31 0 27 27 27 27 0 31 31 0 0 31 31 0 0 31 31 0 0 31 31 0 0 31 31 0 0 31 31 0 0 31 31 0 0 31 31 0 0 0 0 0 31 0 0 31 0 0 0 0 0 0 0 0 0 27 27 27 0 0 0 0 27 27 0 0 0 0 0 0 0 0 0 0 0 0 0 0 0 0 0 0 0 0 0 0 0 0 0 0 27 27 27 27 27 27 27 27 27 27 0 0 0 0 0 0 0 0 0 0 27 27 27 27 
0 0 0 13 0 0 0 0 0 0 0 0 0 0 0 0 0 31 31 0 0 31 31 0 0 31 31 0 0 31 31 0 0 31 31 0 0 31 31 0 0 31 31 0 0 31 31 0 0 31 31 0 0 31 31 0 0 31 31 0 0 0 0 0 31 0 0 31 27 27 27 0 0 0 0 0 0 0 0 0 0 0 0 0 0 0 0 0 0 0 0 0 0 0 0 0 0 0 0 0 0 0 0 0 0 0 0 0 0 0 0 0 27 30 30 30 30 30 30 30 30 27 0 0 0 0 0 0 0 0 0 0 30 30 30 30 
0 0 0 0 0 0 0 0 0 0 0 0 0 0 0 0 27 27 27 27 0 31 31 0 0 31 31 0 0 31 31 0 0 31 31 0 0 31 31 0 0 31 31 0 0 31 31 0 0 31 31 0 0 31 31 0 0 31 31 0 0 0 0 0 27 27 27 27 0 0 0 0 0 0 0 0 0 0 0 0 0 0 0 0 0 0 0 0 0 0 0 0 0 0 0 0 0 0 0 0 0 0 0 0 0 0 0 0 0 0 0 0 27 30 30 30 30 30 30 30 30 27 0 0 0 0 0 0 0 0 0 0 30 30 30 30 
0 0 0 0 0 0 13 0 0 0 0 0 0 0 0 0 0 0 0 0 27 27 27 27 0 31 31 0 0 31 31 0 0 31 31 0 0 31 31 0 0 31 31 0 0 31 31 0 0 31 31 0 0 31 31 0 0 31 31 0 0 0 0 0 31 0 0 31 0 0 0 0 0 0 0 0 0 0 0 0 0 0 0 0 0 0 0 0 27 0 0 0 0 0 0 0 0 0 0 0 0 0 0 0 0 0 0 0 0 0 0 0 27 30 30 30 30 30 30 30 30 27 0 0 0 0 0 0 0 0 0 0 27 27 27 27 
0 0 0 0 0 13 13 13 0 0 0 0 0 0 0 0 0 0 0 0 0 0 0 0 27 27 27 27 0 31 31 0 0 31 31 0 0 31 31 0 27 27 27 27 0 31 31 0 27 27 27 27 0 31 31 0 0 31 31 0 0 0 0 0 31 0 0 31 0 0 0 0 0 0 0 0 0 0 0 0 0 0 0 0 0 0 0 27 27 27 0 0 0 0 0 0 0 0 0 0 0 0 0 0 0 0 0 0 0 0 0 0 30 30 30 30 30 30 30 30 30 30 0 0 0 0 0 0 0 0 0 0 30 30 30 27 
0 0 0 0 0 0 13 0 0 0 0 0 0 0 0 0 0 0 0 0 0 0 0 0 0 0 0 0 27 27 27 27 0 31 31 0 27 27 27 27 0 0 0 0 27 27 27 27 0 0 0 0 0 31 31 0 0 31 31 0 0 27 27 27 31 0 0 31 0 0 0 0 0 0 0 0 0 0 0 0 0 0 0 0 0 0 27 27 27 27 27 0 0 0 0 0 0 0 0 0 0 0 0 0 0 0 0 0 0 0 0 0 30 30 30 30 30 30 30 30 30 30 0 0 0 0 0 0 0 0 0 0 27 30 30 27 
0 0 0 0 0 0 0 0 0 0 0 0 0 0 0 0 0 0 0 0 0 0 0 0 0 0 0 0 0 0 0 0 27 27 27 27 0 0 0 0 0 0 0 0 0 0 0 0 0 0 0 0 0 31 31 0 0 31 31 0 0 0 0 0 27 27 27 27 0 0 0 0 0 0 27 27 27 27 27 0 0 0 0 0 27 27 27 27 27 27 27 27 27 0 0 0 27 27 0 0 0 0 0 0 0 0 0 0 0 0 0 0 30 30 30 30 30 30 30 30 30 27 0 0 0 0 0 0 0 0 0 0 27 30 30 27 
0 13 0 0 0 0 0 0 0 0 0 0 0 0 0 0 0 0 0 0 0 0 0 0 0 0 0 0 0 0 0 0 0 0 0 0 0 0 0 0 0 0 0 0 0 0 0 0 0 0 0 0 0 31 31 0 0 31 31 0 0 0 0 0 0 31 31 0 27 27 27 0 0 0 0 0 31 0 0 0 0 0 0 0 0 0 0 0 31 0 0 0 0 0 0 0 31 31 0 0 0 0 0 0 0 0 0 0 0 0 0 0 30 30 30 30 30 30 30 30 30 27 0 0 27 27 27 27 27 27 27 27 27 27 30 27 
13 13 13 0 0 0 0 0 0 0 0 0 0 0 0 0 0 0 0 0 0 0 0 0 0 0 0 0 0 0 0 0 0 0 0 0 0 0 0 0 0 0 0 0 0 0 0 0 0 0 0 0 0 31 31 0 0 31 31 0 0 0 0 0 0 31 31 0 0 0 0 0 0 0 0 0 31 0 0 0 0 0 0 0 0 0 0 0 31 0 0 0 0 0 0 0 31 31 0 0 0 27 27 27 27 27 27 27 27 0 0 0 30 27 27 27 27 27 27 27 27 27 0 0 0 0 0 0 0 0 0 0 27 30 30 27 
0 13 0 0 0 0 0 0 0 0 0 0 0 0 0 0 0 0 0 0 0 0 0 0 0 0 0 0 0 0 0 0 0 0 0 0 0 0 0 0 0 0 0 0 0 0 0 0 0 0 0 0 0 31 31 0 0 31 31 0 0 0 0 0 0 31 31 0 0 0 0 0 0 0 0 0 31 0 0 0 0 0 0 0 0 0 0 0 31 0 0 0 0 0 0 0 31 31 0 0 0 0 0 0 31 31 0 0 0 0 0 0 0 0 0 0 0 0 0 0 0 0 0 0 0 0 0 0 0 0 0 0 27 30 30 27 
0 0 0 0 0 13 0 0 0 0 0 0 0 0 0 0 0 0 0 0 0 0 0 0 0 0 0 0 0 0 0 0 0 0 0 0 0 0 0 0 0 0 0 0 0 0 0 0 0 0 0 0 0 31 31 0 0 31 31 0 0 0 0 0 0 31 31 0 0 0 0 0 0 0 0 0 31 0 0 0 0 0 0 0 0 0 0 0 31 0 0 0 0 0 0 0 31 31 0 0 0 0 0 0 31 31 0 0 0 0 0 0 0 0 0 0 0 0 0 0 0 0 0 0 0 0 0 0 0 0 0 0 27 27 30 27 
0 0 0 0 13 13 13 0 0 0 0 0 0 0 0 0 0 0 0 0 0 0 0 0 0 0 0 0 0 0 0 0 0 0 0 0 0 0 0 0 0 0 0 0 0 0 0 0 0 0 0 0 0 31 31 0 0 31 31 0 0 0 0 0 26 26 26 26 26 26 26 26 26 26 26 26 26 26 26 26 26 26 26 26 26 26 26 26 26 26 26 26 26 26 26 26 26 26 26 26 26 26 26 26 26 26 26 26 26 26 26 26 26 26 26 26 26 0 0 0 0 0 0 0 0 0 0 0 0 0 0 0 27 30 30 27 
0 0 0 0 0 13 0 0 0 0 0 0 0 0 0 0 0 0 0 0 0 0 0 0 0 0 0 0 0 0 0 0 0 0 0 0 0 0 0 0 0 0 0 0 0 0 0 0 0 0 0 0 0 31 31 0 0 31 31 0 0 0 0 0 26 31 31 31 31 31 31 31 31 31 31 31 31 31 31 31 31 31 31 31 31 31 31 31 31 31 31 31 31 31 31 31 31 31 31 31 31 31 31 31 31 31 31 31 31 31 31 31 31 31 31 31 26 0 0 0 0 0 0 0 0 0 0 0 0 0 0 0 27 30 30 27 
13 0 0 0 0 0 0 0 0 0 0 0 0 0 0 0 0 0 0 0 0 0 0 0 0 0 0 0 0 0 0 0 0 0 0 0 0 0 0 0 0 0 0 0 0 0 0 0 0 0 0 0 0 31 31 0 0 31 31 0 0 0 0 0 26 31 31 31 31 31 31 31 31 31 31 31 31 31 31 31 31 31 31 31 31 31 31 31 31 31 31 31 31 31 31 31 31 31 31 31 31 31 31 31 31 31 31 31 31 31 31 31 31 31 31 31 26 0 0 0 0 0 0 0 0 0 0 0 0 0 0 0 27 27 30 27 
13 13 0 0 0 0 0 0 0 0 0 0 0 0 0 0 0 0 0 0 0 0 0 0 0 0 0 0 0 0 0 0 0 0 0 0 0 0 0 0 0 15 15 15 15 15 15 15 15 15 15 15 31 31 31 31 31 31 31 31 31 31 31 31 26 31 31 31 31 31 31 31 31 31 31 31 31 31 31 31 31 31 31 31 31 31 31 31 31 31 31 31 31 31 31 31 31 31 31 31 31 31 31 31 31 31 31 31 31 31 31 31 31 31 31 31 26 0 0 0 0 0 0 0 0 0 0 0 0 0 0 27 27 30 30 27 27 
13 0 0 0 0 0 0 0 15 15 15 15 15 15 15 15 15 15 15 15 15 15 15 15 15 15 15 15 15 15 15 15 15 15 15 0 0 0 0 0 0 31 31 31 15 31 31 31 31 31 31 31 0 0 0 0 0 0 0 0 0 0 0 0 26 31 31 31 31 31 31 31 31 31 31 31 31 31 31 31 31 31 31 31 31 31 31 31 31 31 31 31 31 31 31 31 31 31 31 31 31 31 31 31 31 31 31 31 31 31 31 26 31 31 31 31 26 0 0 0 0 0 0 0 0 0 0 0 0 0 0 27 27 30 30 27 27 
0 0 0 0 0 0 0 0 15 31 31 31 31 31 15 31 31 31 31 31 31 31 31 31 15 31 31 31 31 15 0 0 0 0 15 0 0 0 15 0 0 31 0 0 15 31 31 31 31 31 31 31 0 0 0 15 0 0 0 0 0 0 0 0 26 31 31 31 31 31 31 31 31 31 31 31 31 31 31 31 31 31 31 31 31 31 31 31 31 31 31 31 31 31 31 31 31 31 31 31 31 31 31 31 31 31 31 31 31 31 31 26 31 31 31 31 26 0 0 0 0 0 0 0 0 0 0 0 0 0 0 27 27 27 30 30 27 
0 0 13 0 0 0 0 0 31 31 31 31 31 31 31 31 31 31 31 31 31 31 31 31 31 31 31 31 31 15 0 0 0 0 15 0 0 0 31 0 0 31 0 0 15 31 31 31 31 31 31 31 0 0 0 31 0 0 0 0 0 0 0 0 26 31 31 31 31 31 31 31 31 31 31 31 31 31 31 31 31 31 31 31 31 31 31 31 31 31 31 31 31 31 31 31 31 31 31 31 31 31 31 31 31 31 31 31 31 31 31 26 31 31 31 31 26 0 0 0 0 0 0 0 0 0 0 0 0 0 0 27 30 30 30 30 27 
0 13 13 13 0 0 0 0 15 31 31 31 31 31 15 31 31 31 31 31 31 31 31 31 15 31 31 31 31 15 0 0 0 0 0 0 0 0 31 0 0 15 0 0 15 15 15 15 15 15 15 31 0 0 0 31 0 0 0 0 0 0 0 0 26 31 31 31 26 26 26 26 26 26 26 26 26 26 26 26 26 26 26 26 26 26 26 26 26 26 26 26 26 26 26 26 26 26 26 26 26 26 26 26 26 26 26 26 26 26 26 26 26 26 26 26 26 0 0 0 0 0 0 0 0 0 0 0 0 0 0 27 30 30 30 30 27 
0 0 13 0 0 0 0 0 15 31 31 31 31 31 15 31 31 31 31 31 31 31 31 31 15 31 31 31 31 15 0 0 0 0 0 0 0 0 31 0 0 31 0 0 0 0 0 0 0 0 0 0 15 0 0 31 0 0 0 0 0 0 0 0 26 31 31 31 31 31 31 31 31 31 31 31 31 31 31 31 31 31 31 31 31 31 31 31 31 31 31 31 31 31 31 31 31 31 31 31 31 31 31 31 31 31 31 31 31 31 31 31 31 31 31 31 26 0 0 0 0 0 0 0 0 0 0 0 0 0 0 27 30 30 30 27 27 
0 0 0 0 0 13 0 0 15 31 31 31 31 31 15 31 31 31 31 31 31 31 31 31 15 31 31 31 31 15 0 0 0 0 0 0 0 0 15 0 0 31 0 0 0 0 0 0 0 0 0 0 31 0 0 31 0 0 0 0 0 0 0 0 26 31 31 31 31 31 31 31 31 31 31 31 31 31 31 31 31 31 31 31 31 31 31 31 31 31 31 31 31 31 31 31 31 31 31 31 31 31 31 31 31 31 31 31 31 31 31 31 31 31 31 31 26 0 0 0 0 0 0 0 0 0 0 0 0 0 0 27 30 30 30 30 27 
0 0 0 0 13 13 13 0 15 15 15 15 15 15 15 15 15 15 15 15 15 15 15 15 15 15 15 15 15 15 15 15 15 15 15 0 0 0 31 0 0 31 0 0 0 0 0 0 0 0 0 0 31 0 0 31 0 0 0 0 0 0 0 0 26 2 31 31 31 31 31 31 31 31 31 31 31 31 31 31 31 31 31 31 31 31 31 31 31 31 31 31 31 31 31 31 31 31 31 31 31 31 31 31 31 31 31 31 31 31 31 31 31 31 31 31 26 0 0 0 0 0 0 0 0 0 0 0 0 0 0 27 30 30 30 30 30 
0 0 0 0 0 13 0 0 15 31 31 31 31 31 15 31 31 31 31 31 31 31 31 31 15 31 31 31 31 15 31 31 31 31 15 0 0 0 31 0 0 15 0 0 0 0 0 0 0 0 0 0 31 0 0 15 0 0 0 0 0 0 0 0 26 2 2 31 31 31 31 31 31 31 31 31 31 31 31 31 31 31 31 31 31 31 31 31 31 31 31 31 31 31 31 31 31 31 31 31 31 31 31 31 31 31 31 31 31 31 31 31 31 31 31 31 26 0 0 0 0 0 0 0 0 0 0 0 0 0 0 27 27 30 30 30 30 
0 13 0 0 0 0 0 0 31 31 31 31 31 31 31 31 31 31 31 31 31 31 31 31 31 31 31 31 31 31 31 31 31 31 31 0 0 0 31 0 0 31 0 0 0 0 0 0 0 0 0 0 31 0 0 31 0 0 0 0 0 0 0 0 26 2 2 2 31 31 31 31 31 31 31 31 31 31 31 31 31 31 31 31 31 31 31 31 31 31 31 31 31 31 31 31 31 31 31 31 31 31 31 31 31 31 31 31 31 31 31 31 31 31 31 31 31 0 0 0 0 0 0 0 0 0 0 0 0 0 0 27 30 30 30 30 30 
13 13 13 0 0 0 13 0 15 31 31 31 31 31 15 31 31 31 31 31 31 31 31 31 15 31 31 31 31 15 31 31 31 31 15 0 0 0 15 0 0 31 0 0 0 0 0 0 0 0 0 0 31 0 0 31 0 0 0 0 0 0 0 0 26 2 2 2 31 31 31 31 31 31 31 31 31 31 31 31 31 31 31 31 31 31 31 31 31 31 31 31 31 31 31 31 31 31 31 31 31 31 31 31 31 31 31 31 31 31 31 31 31 31 31 31 31 0 0 0 0 0 0 0 0 0 0 0 0 0 0 27 30 30 30 30 27 27 27 27 27 27 
0 13 0 0 0 13 13 13 15 31 31 31 31 31 15 31 31 31 31 31 31 31 31 31 15 31 31 31 31 15 31 31 31 31 15 0 0 0 31 0 0 31 0 0 0 0 0 0 0 0 0 0 15 0 0 31 0 0 0 0 0 0 0 0 26 26 26 26 26 26 26 26 26 26 26 26 26 26 26 26 26 26 26 26 26 26 26 26 26 26 26 26 26 26 26 26 26 26 26 26 26 26 26 26 26 26 26 26 26 26 26 26 26 26 31 31 31 0 0 0 0 0 0 0 0 0 0 0 0 0 0 27 30 30 30 30 27 27 27 27 27 27 
0 0 0 0 0 0 13 0 15 31 31 31 31 31 15 31 31 31 31 31 31 31 31 31 15 31 31 31 31 15 31 31 31 31 15 0 0 0 31 0 0 15 0 0 0 0 0 0 0 0 0 0 31 0 0 31 0 0 0 0 0 0 0 0 26 31 31 31 31 31 31 31 31 31 31 31 31 31 31 31 31 31 31 31 31 31 31 31 31 31 31 31 31 31 31 31 31 31 31 31 31 31 31 31 31 31 31 31 31 31 31 31 31 31 31 31 26 0 0 0 0 0 0 0 0 0 0 0 0 0 0 27 27 27 27 27 27 27 27 27 27 27 27 27 
0 0 0 13 0 0 0 0 15 15 15 15 15 15 15 15 15 15 15 15 15 15 15 15 15 15 15 15 15 15 15 15 15 15 15 0 0 0 31 0 0 31 0 0 0 0 0 0 0 0 0 0 31 0 0 31 0 0 0 0 0 0 0 0 26 31 31 31 31 31 31 31 31 31 31 31 31 31 31 31 31 31 31 31 31 31 31 31 31 31 31 31 31 31 31 31 31 31 31 31 31 31 31 31 31 31 31 31 31 31 31 31 31 31 31 31 26 0 0 0 0 0 0 0 0 0 0 0 0 0 0 27 30 30 30 30 27 30 30 30 30 30 30 27 
0 0 13 13 13 0 0 0 15 31 31 31 31 31 15 31 31 31 31 15 31 31 31 31 15 31 31 31 31 31 31 31 31 31 15 0 0 0 15 0 0 31 0 0 0 0 0 0 0 0 0 0 31 0 0 15 0 0 0 0 0 0 0 0 26 31 31 31 31 31 31 31 31 31 31 31 31 31 31 31 31 31 31 31 31 31 31 31 31 31 31 31 31 31 31 31 31 31 31 31 31 31 31 31 31 31 31 31 31 31 31 31 31 31 31 26 26 26 0 0 0 0 0 0 0 0 0 0 0 0 0 30 30 30 30 30 30 30 30 30 30 30 30 27 27 27 
0 0 0 13 0 0 0 0 31 31 31 31 31 31 31 31 31 31 31 31 31 31 31 31 31 31 31 31 31 31 31 31 31 31 31 0 0 0 31 0 0 31 0 0 0 0 0 0 0 0 0 0 31 0 0 31 0 0 0 0 0 0 0 0 0 31 31 31 31 31 31 31 31 31 31 31 31 31 31 31 31 31 31 31 31 31 31 31 31 31 31 31 31 31 31 31 31 31 31 31 31 31 31 31 31 31 31 31 31 31 31 31 31 31 31 31 26 0 0 0 0 0 0 0 0 0 0 0 0 0 0 30 30 30 30 30 30 30 30 30 30 30 30 27 27 27 
0 0 0 0 0 0 0 13 15 31 31 31 31 31 15 31 31 31 31 15 31 31 31 31 15 31 31 31 31 31 31 31 31 31 15 0 0 0 31 0 0 15 0 0 0 0 0 0 0 0 0 0 31 0 0 31 0 0 0 0 0 0 0 0 0 31 31 31 31 31 31 31 31 31 31 31 31 31 31 31 31 31 31 31 31 31 31 31 31 31 31 31 31 31 31 31 31 31 31 31 31 31 31 31 31 31 31 31 31 31 31 31 31 31 31 31 26 0 0 0 0 0 0 0 0 0 0 0 0 0 0 30 30 30 30 30 30 30 30 30 30 30 30 27 27 27 27 
0 0 0 0 0 0 13 13 15 31 31 31 31 31 15 31 31 31 31 15 31 31 31 31 15 31 31 31 31 31 31 31 31 31 15 0 0 0 31 0 0 31 0 0 0 0 0 0 0 0 0 0 15 0 0 31 0 0 0 0 0 0 0 0 0 31 31 31 31 31 31 31 31 31 31 31 31 31 31 31 31 31 31 31 31 31 31 31 31 31 31 31 31 31 31 31 31 31 31 31 31 31 31 31 31 31 31 31 31 31 31 31 31 31 26 26 26 26 26 0 0 0 0 0 0 0 0 0 0 0 0 30 30 30 30 30 30 30 30 30 30 30 30 30 30 30 30 
0 0 0 0 0 13 13 13 15 31 31 31 31 31 15 31 31 31 31 15 31 31 31 31 15 31 31 31 31 31 31 31 31 31 15 0 0 0 31 0 0 31 0 0 0 0 0 0 0 0 0 0 31 0 0 31 0 0 0 0 0 0 0 0 0 26 26 26 26 26 26 26 26 26 26 26 26 26 26 26 26 26 26 26 26 26 26 26 26 26 26 26 26 26 26 26 26 26 26 26 26 26 26 26 26 26 26 26 26 26 26 26 26 26 26 26 26 26 26 26 0 0 0 0 0 0 0 0 0 0 0 30 30 30 30 30 30 30 30 30 30 30 30 30 30 30 30 
14 14 14 14 14 14 14 14 14 14 14 14 14 14 14 14 14 14 14 14 14 14 14 14 14 14 14 14 14 14 14 14 14 14 14 14 14 14 14 14 14 14 14 14 14 14 30 30 30 30 30 30 31 30 30 14 14 14 14 14 14 14 14 14 14 14 14 14 14 14 14 14 14 14 14 14 14 14 14 14 14 14 14 14 14 14 14 14 14 14 14 14 14 14 14 14 14 14 14 14 14 14 14 14 14 14 14 14 14 14 14 14 14 14 14 14 14 14 14 14 14 14 14 14 30 30 30 30 14 14 30 30 30 14 14 30 30 30 30 14 14 14 14 14 14 14 14 14 14 14 
