0 
0 0 0 0 0 0 0 0 0 0 0 0 0 0 0 0 0 0 0 0 0 0 0 0 0 0 0 0 0 0 0 0 0 0 0 0 0 0 0 0 0 0 0 0 0 0 0 0 0 0 0 0 0 0 0 0 0 0 13 13 13 13 13 13 13 13 13 13 0 0 0 0 0 0 0 0 0 0 0 0 0 0 0 0 0 0 0 0 0 0 0 0 0 0 0 0 0 0 0 0 0 0 0 0 0 0 0 0 0 0 0 0 0 0 0 0 0 0 0 0 0 0 0 0 0 0 0 0 0 0 0 0 0 0 0 0 0 0 0 0 0 0 0 0 0 0 0 0 0 0 0 0 0 0 0 0 0 0 0 0 0 0 0 0 0 0 0 0 0 0 0 0 0 0 0 0 0 0 0 0 0 0 0 0 0 0 0 0 0 0 0 0 0 0 0 0 0 0 0 0 0 0 0 0 0 0 0 0 0 0 0 0 0 0 0 0 0 0 0 0 0 0 0 0 0 0 0 0 0 0 0 0 0 0 0 0 0 0 0 0 0 0 0 0 0 0 0 0 7 7 
0 0 0 0 0 0 0 0 0 0 0 0 0 0 0 0 0 0 0 0 0 0 0 0 0 0 0 0 0 0 0 0 0 0 0 0 0 0 0 0 0 0 0 0 0 0 0 0 0 0 0 0 0 0 0 0 0 0 13 31 31 31 31 31 31 31 31 13 0 0 0 0 0 0 0 0 0 0 0 0 0 0 0 0 0 0 0 0 0 0 0 0 0 0 0 0 0 0 0 0 0 0 0 0 0 0 0 0 0 0 0 0 0 0 0 0 0 0 0 0 0 0 0 0 0 0 0 0 0 0 0 0 0 0 0 0 0 0 0 0 0 0 0 0 0 0 0 0 0 0 0 0 0 0 0 0 0 0 0 0 0 0 0 0 0 0 0 0 0 0 0 0 0 0 0 0 0 0 0 0 0 0 0 0 0 0 0 0 0 0 0 0 0 0 0 0 0 0 0 0 0 0 0 0 0 0 0 0 0 0 0 0 0 0 0 0 0 0 0 0 0 0 0 0 0 0 0 0 0 0 0 0 0 0 0 0 0 0 0 0 0 0 0 0 0 0 7 7 32 32 7 7 
0 0 0 0 0 0 0 0 0 0 0 0 0 0 0 0 0 0 0 0 0 0 0 0 0 0 0 0 0 0 0 0 0 0 0 0 0 0 0 0 0 0 0 0 0 0 0 0 0 0 0 0 0 0 0 0 0 0 31 31 31 31 31 31 31 31 31 13 0 0 0 0 0 0 0 0 0 0 0 0 0 0 0 0 0 0 0 0 0 0 0 0 0 0 0 0 0 0 0 0 0 0 0 0 0 0 0 0 0 0 0 0 0 13 13 13 13 13 13 13 13 13 13 13 13 13 13 13 13 13 13 13 13 13 13 13 13 13 0 0 0 0 0 0 0 0 0 0 0 0 0 0 0 0 0 0 0 0 0 0 0 0 0 0 0 0 0 0 0 0 4 4 4 4 4 4 4 4 4 0 0 0 0 0 0 0 0 0 0 0 4 4 4 0 0 4 4 4 0 0 0 0 0 0 0 0 0 0 0 0 0 0 0 0 0 0 0 0 0 0 0 0 0 0 0 0 0 0 0 0 0 0 0 0 0 0 0 0 0 0 0 0 0 0 7 7 32 32 32 32 32 32 7 7 0 0 0 0 0 0 0 0 0 0 0 0 0 0 0 0 0 0 0 0 0 0 0 0 0 0 0 0 0 0 9 9 9 
4 4 4 4 4 4 4 4 0 0 0 0 0 0 0 0 0 0 0 0 0 0 0 0 5 5 5 5 0 0 7 7 7 7 7 0 0 0 0 0 0 0 0 0 0 0 0 0 0 0 0 0 0 0 0 0 0 0 31 31 31 31 31 31 31 31 31 13 0 0 0 0 0 0 0 0 0 0 0 0 0 0 0 0 0 0 0 0 0 0 0 0 0 0 0 0 0 0 0 0 0 0 0 0 0 0 0 0 0 0 0 0 0 13 31 31 31 31 31 31 31 31 31 31 31 31 31 31 13 13 13 31 31 31 31 31 31 13 0 0 0 0 0 0 0 0 0 0 0 0 0 0 0 0 0 0 0 0 0 0 0 0 0 0 0 0 0 0 4 4 29 29 29 29 29 29 29 29 4 4 4 4 0 0 0 0 0 0 0 0 0 0 0 0 0 0 0 0 0 0 0 0 0 0 0 0 0 0 0 0 0 0 0 0 0 0 0 0 0 7 7 7 0 0 0 0 7 7 7 0 0 0 0 0 0 0 0 0 0 0 0 0 0 32 32 32 32 32 32 32 32 32 32 32 0 0 0 0 0 0 0 0 0 0 0 0 0 0 0 0 0 0 4 4 4 4 0 0 0 0 0 0 0 0 9 9 9 
0 0 0 0 0 0 0 0 0 0 0 4 4 0 0 0 0 0 0 0 0 0 0 0 0 0 0 0 0 0 7 29 29 29 7 0 0 0 0 0 0 0 0 0 0 0 0 0 0 0 0 0 0 0 0 0 0 0 13 31 31 31 31 31 31 31 31 31 0 0 0 0 0 0 0 0 0 0 0 0 0 0 0 0 0 0 0 0 0 0 0 0 0 0 0 0 0 0 0 0 0 0 0 0 0 0 0 0 0 0 0 0 0 13 31 31 31 31 31 31 31 31 31 31 31 31 31 31 31 31 31 31 31 31 31 31 31 13 0 0 0 0 0 0 0 0 0 0 0 0 0 0 0 0 0 0 0 0 0 0 0 0 0 0 0 0 4 4 4 4 29 4 4 4 4 4 4 29 4 4 4 4 4 4 4 0 0 0 0 0 0 0 0 0 0 0 0 0 0 0 0 0 0 0 0 0 0 0 0 0 0 0 0 0 0 0 0 0 0 0 0 0 0 0 0 0 0 0 0 0 0 0 0 0 0 0 0 0 0 0 0 0 32 32 32 32 32 32 32 32 32 32 32 32 0 0 0 0 0 0 0 0 0 0 0 0 0 0 0 0 0 0 0 0 0 0 0 0 0 0 0 0 0 0 9 9 9 
0 0 0 0 0 0 0 0 0 0 0 0 0 0 0 0 0 0 0 0 0 0 0 0 0 0 0 0 0 0 7 29 29 29 7 0 0 0 0 7 7 7 7 7 0 0 0 0 0 0 0 0 0 0 2 0 0 0 13 31 31 31 31 31 31 31 31 31 0 0 0 0 0 0 0 0 0 0 0 0 0 0 0 0 0 0 0 0 0 0 0 0 0 0 0 0 0 0 0 0 0 0 0 0 13 13 13 13 13 13 13 13 13 13 31 31 31 31 31 31 31 31 31 31 31 31 31 31 31 31 31 31 31 31 31 31 31 13 0 0 0 0 0 0 0 0 0 0 0 0 0 0 0 0 0 0 0 0 0 0 0 0 0 0 4 4 4 4 4 4 29 4 29 29 29 29 29 29 4 4 4 4 4 4 4 4 4 4 0 0 0 0 0 0 0 0 0 0 0 0 0 0 0 0 0 0 0 0 0 0 0 0 0 0 0 0 0 0 0 0 0 0 0 0 0 0 0 0 0 0 0 0 0 7 32 32 7 7 32 32 32 32 7 7 7 7 32 32 32 32 32 32 32 32 32 0 0 0 0 0 0 0 0 0 0 0 0 0 0 0 0 0 0 0 0 0 0 0 0 0 4 0 0 0 9 9 9 
0 0 0 0 0 0 0 0 0 0 0 0 0 0 0 0 0 4 0 0 0 0 0 0 0 0 0 0 0 0 7 29 29 29 7 0 0 0 7 29 29 29 29 29 7 0 0 0 0 0 0 0 0 0 0 0 0 0 13 13 13 13 13 13 13 13 31 31 0 0 0 0 0 13 13 13 13 13 31 31 31 13 13 13 13 13 0 0 0 0 13 13 0 0 0 0 0 0 0 0 0 0 0 0 13 31 31 31 31 31 31 31 31 13 31 31 31 31 31 31 31 31 31 31 31 31 31 31 31 31 31 31 31 31 31 31 31 13 0 0 0 0 0 0 0 0 0 0 0 0 0 0 0 0 0 0 0 0 0 0 3 0 4 4 4 4 4 4 4 29 29 4 29 4 4 4 4 4 4 4 4 4 4 4 4 4 4 4 4 4 29 29 29 29 29 29 29 29 29 29 29 29 29 29 29 29 29 4 4 4 4 4 0 0 0 0 0 0 0 0 0 0 0 0 0 0 0 0 0 0 0 0 0 7 32 32 7 7 32 32 32 32 7 7 7 7 32 32 32 32 32 32 32 7 7 0 0 7 7 0 0 4 4 4 0 0 0 0 0 0 0 0 0 0 0 0 0 0 0 4 29 0 0 0 9 9 9 
0 0 0 0 0 0 0 0 0 0 0 0 0 0 0 0 0 0 0 0 0 0 0 0 0 0 0 0 0 0 29 29 29 29 29 0 0 0 7 29 29 29 29 29 7 0 0 0 0 0 0 2 0 0 0 0 2 0 31 31 31 31 31 31 31 13 13 13 0 0 0 0 0 13 31 31 31 31 31 31 31 31 31 31 31 31 0 0 0 0 31 13 13 0 0 0 0 0 0 0 0 0 0 0 13 31 31 31 31 31 31 31 31 31 31 31 31 13 13 13 13 13 13 13 13 13 13 13 13 13 13 13 13 13 13 31 31 13 0 0 0 0 0 0 0 0 0 0 0 0 0 0 0 0 0 0 0 0 0 0 4 4 4 29 4 4 4 4 4 29 4 4 29 29 29 29 29 29 4 29 29 29 29 29 29 29 4 4 4 4 4 4 29 29 29 29 29 29 29 29 29 29 29 29 29 29 29 29 29 29 29 29 4 0 0 0 0 0 0 0 0 0 0 0 0 0 0 0 0 0 0 0 0 7 32 32 7 7 32 32 32 32 7 7 7 7 32 32 32 32 32 32 32 7 7 0 0 7 7 0 0 29 29 29 4 4 4 0 0 0 0 0 0 0 0 0 0 0 4 4 29 0 0 0 9 9 9 
0 0 0 0 0 0 0 0 0 0 0 4 4 4 4 0 0 0 0 0 4 0 0 0 0 0 0 0 0 0 29 29 29 29 29 0 0 0 7 29 29 29 29 29 7 0 0 0 0 0 0 0 0 0 0 0 0 0 31 31 31 31 31 31 31 31 31 13 0 0 0 13 13 13 31 31 31 31 31 31 31 31 31 31 31 31 0 0 0 0 31 31 13 13 0 0 0 0 0 0 0 0 0 0 13 31 31 31 31 31 31 31 31 31 31 31 13 13 31 31 31 31 31 31 31 31 31 31 31 31 31 31 31 31 13 31 31 13 0 0 0 0 0 0 0 0 0 0 0 0 0 0 0 0 0 0 0 0 4 4 4 4 29 29 29 4 4 4 4 29 4 4 4 4 4 4 4 29 4 29 29 4 4 4 4 29 4 4 4 4 4 4 4 4 29 29 29 29 29 29 29 29 4 4 4 29 29 29 29 29 29 29 29 4 0 0 0 0 0 0 0 0 0 0 0 0 0 0 0 0 0 0 0 7 2 32 7 7 32 32 32 32 7 7 7 7 32 32 32 32 32 32 7 7 7 33 33 7 7 33 33 4 4 29 29 29 29 4 4 4 0 0 0 0 0 0 0 4 4 29 29 0 0 9 9 9 9 
0 0 0 0 0 0 0 0 0 0 4 4 4 4 4 0 0 0 0 0 4 0 0 0 0 0 0 0 0 0 29 29 29 29 7 0 0 0 7 29 29 29 29 29 7 0 0 0 0 0 0 0 0 0 0 0 0 0 31 31 31 31 31 31 31 31 31 13 0 0 0 13 31 31 31 31 31 31 1 31 31 31 31 31 31 31 0 0 0 0 31 31 31 13 13 0 0 0 0 0 0 0 0 0 31 31 31 31 31 31 31 31 31 13 31 31 13 31 31 31 31 31 31 31 31 31 31 31 31 31 31 31 31 31 13 31 31 13 0 0 0 0 0 0 0 0 0 0 0 0 0 0 0 0 0 0 4 4 4 4 4 29 29 4 29 29 4 4 4 29 29 4 29 29 29 29 29 29 4 29 4 29 29 29 29 29 29 29 29 29 29 4 4 4 4 4 29 29 29 29 29 29 29 29 29 29 29 29 29 29 29 29 29 29 4 0 0 0 0 0 0 0 0 0 0 0 0 0 0 0 0 0 0 7 32 32 7 7 7 32 32 32 7 7 7 7 32 32 32 32 32 7 7 7 7 33 33 7 7 33 33 4 4 4 4 4 29 29 29 29 4 4 4 0 0 0 4 4 29 29 4 0 0 9 9 9 9 
0 0 0 0 0 0 0 0 0 4 4 4 4 4 4 33 33 33 33 33 4 1 0 0 0 0 0 0 0 0 7 29 29 29 7 0 0 0 7 29 29 29 29 29 7 0 0 0 0 0 0 0 2 0 0 2 0 0 31 31 31 31 31 31 31 31 31 13 0 0 0 13 31 31 31 31 13 13 13 13 13 13 13 13 31 31 0 0 0 0 31 31 31 31 31 0 0 0 0 0 0 0 0 0 31 31 31 31 31 31 31 31 31 13 31 31 13 31 31 31 31 31 31 31 31 31 31 31 31 31 31 31 31 31 13 13 31 13 0 0 0 0 0 0 0 0 0 0 0 0 0 0 0 0 4 4 4 4 4 4 29 29 4 4 4 29 29 4 4 4 29 4 29 4 4 4 4 4 4 29 4 29 4 4 4 4 4 4 4 4 4 4 4 4 4 4 4 4 29 29 29 29 29 29 29 29 29 29 29 29 29 29 29 29 29 4 0 0 0 7 32 32 32 32 7 0 0 0 7 7 32 7 7 7 32 32 7 7 7 32 32 32 7 7 7 7 32 32 32 32 32 7 7 7 7 33 33 7 7 33 33 4 4 4 4 4 4 4 4 29 29 29 29 4 4 4 4 29 29 4 4 33 33 9 9 9 9 
0 0 0 0 0 0 0 0 4 4 4 4 4 4 4 33 33 33 33 33 4 1 1 0 0 0 0 0 0 0 7 29 29 29 7 0 2 0 29 29 29 29 29 29 29 0 0 2 0 0 0 0 0 0 0 0 0 0 2 31 31 31 31 31 31 31 31 31 0 13 0 31 31 31 31 31 31 31 31 31 31 31 31 31 31 31 0 0 0 0 31 31 31 31 31 0 0 0 0 0 0 0 0 0 31 31 31 31 31 31 31 31 31 13 31 1 13 31 31 31 31 31 31 31 31 31 31 31 31 31 31 31 13 31 31 31 31 31 0 0 0 0 0 0 0 0 0 0 0 0 0 0 4 4 4 29 29 29 29 29 29 4 4 4 4 4 29 29 29 29 29 4 29 29 29 29 29 29 29 29 4 29 29 29 29 29 29 29 29 29 29 29 29 29 29 29 29 29 29 4 4 29 29 29 29 29 29 29 29 29 29 29 29 29 29 29 29 0 0 7 32 32 32 32 7 0 0 0 7 32 32 32 32 32 32 2 7 7 7 32 32 32 32 32 32 32 32 32 32 32 7 7 7 7 7 33 33 7 7 33 33 4 4 4 4 4 4 4 4 4 4 4 29 29 29 29 29 29 4 4 4 33 33 9 9 9 9 
4 4 4 4 4 4 4 4 4 4 4 4 4 4 4 33 33 33 33 33 4 4 4 4 4 4 4 4 4 4 4 4 4 4 4 4 4 4 4 4 4 4 4 4 4 4 4 4 4 4 4 4 33 33 33 33 33 33 4 4 4 4 4 4 4 4 4 4 4 4 4 4 33 33 33 33 33 33 33 33 33 33 33 33 33 33 33 33 33 33 33 33 33 33 33 33 33 33 4 4 4 4 4 4 13 13 13 13 13 13 13 13 13 13 13 13 13 13 13 13 13 13 13 13 13 13 13 13 13 13 13 13 13 13 13 13 13 13 13 0 0 4 4 4 4 4 4 4 4 4 4 4 4 4 4 4 4 4 4 4 4 4 4 4 4 4 4 4 4 4 4 4 4 4 4 4 4 4 4 4 4 4 4 4 4 4 4 4 4 4 4 4 4 4 4 4 4 4 4 4 4 4 4 4 4 33 33 33 33 33 33 33 33 4 4 4 4 4 4 7 7 7 7 7 7 33 33 33 7 7 7 7 7 7 7 7 7 7 7 7 7 7 7 7 7 7 7 7 7 7 7 7 7 7 7 33 33 7 7 33 33 4 4 4 4 4 4 4 4 4 4 4 4 4 4 4 4 4 4 4 4 33 33 9 9 9 9 
