0 
0 
0 
0 0 0 0 0 0 0 0 18 18 28 28 18 18 18 18 18 18 18 18 18 
0 0 0 0 0 0 0 0 0 18 28 28 28 28 18 18 18 18 18 18 18 
0 0 0 0 0 0 0 0 0 18 28 29 29 28 18 18 18 18 18 18 18 
0 0 0 0 0 0 0 0 2 18 28 29 29 28 18 18 18 18 18 18 18 
0 0 0 0 0 0 0 2 2 18 28 29 29 28 18 28 28 28 28 28 18 0 0 0 0 0 18 
0 0 0 0 0 18 18 18 18 18 28 29 29 28 18 28 29 29 29 28 28 0 0 0 0 18 28 
0 0 0 0 18 18 28 28 28 18 28 29 29 28 18 28 29 29 29 18 18 18 0 0 0 28 29 0 0 0 0 18 
0 0 0 18 18 28 28 28 28 18 28 29 29 28 18 28 29 29 29 29 18 0 0 0 0 29 0 0 0 0 0 28 
18 0 0 0 0 0 0 0 28 18 28 29 29 28 18 18 18 29 29 29 18 0 0 0 0 0 0 0 0 0 0 29 
18 18 0 0 0 0 0 0 28 18 28 29 29 28 18 28 29 28 28 29 18 0 0 0 0 0 0 0 0 0 0 0 0 0 18 0 0 0 0 0 0 0 0 0 0 0 0 0 0 0 0 0 0 0 0 0 0 0 0 0 0 0 0 0 0 0 0 0 0 0 0 0 0 0 0 18 18 18 
28 18 18 0 0 0 0 0 28 18 28 29 29 28 18 28 29 18 18 29 18 0 0 0 0 0 0 0 0 0 0 0 0 0 28 18 18 18 18 18 0 0 0 0 0 0 0 0 0 0 0 16 0 16 29 28 18 18 18 18 18 18 18 18 18 18 18 18 18 18 18 18 28 18 18 18 18 18 18 18 18 18 18 18 18 18 18 
28 28 18 18 18 18 18 0 28 18 28 29 29 28 18 28 29 29 29 29 18 0 0 0 0 0 0 0 0 0 0 0 0 0 29 28 28 28 28 28 0 0 0 0 0 0 0 0 0 0 0 16 0 16 29 28 18 29 29 29 29 29 29 29 29 29 29 29 29 29 29 29 29 29 29 29 29 29 29 29 29 29 29 29 29 29 18 
0 0 0 0 0 0 0 0 28 18 28 29 29 28 18 28 29 28 28 28 18 0 0 0 0 0 0 0 0 0 0 0 0 0 0 29 29 29 29 29 0 0 0 0 0 0 0 0 0 0 0 16 0 16 29 28 18 29 29 29 29 29 29 29 29 29 29 29 29 29 29 29 29 29 29 29 29 29 29 29 29 29 29 29 29 29 18 
0 0 0 0 0 0 0 0 28 18 28 29 29 28 18 28 29 28 28 18 18 0 0 0 0 0 0 0 0 0 0 0 0 0 0 0 0 0 0 0 0 0 0 18 0 0 0 0 0 0 0 16 0 16 29 28 18 29 29 29 29 29 29 29 29 29 29 29 29 29 29 29 18 29 29 29 29 29 29 29 29 29 29 29 29 29 18 
0 0 0 0 0 0 0 0 18 18 28 29 29 28 18 28 28 29 29 29 18 0 0 0 0 0 0 0 0 0 0 0 0 0 0 0 0 0 0 0 0 0 0 28 0 0 0 0 0 0 0 29 29 29 29 28 18 29 29 29 29 29 29 29 29 29 29 29 29 29 29 29 18 29 29 29 29 29 29 29 29 29 29 29 29 29 18 0 0 0 0 0 0 0 0 0 0 0 0 0 0 0 0 0 0 0 0 0 0 0 0 0 0 0 0 0 0 0 0 0 0 0 0 0 0 0 0 0 0 0 0 0 0 0 0 0 0 0 0 0 0 0 18 18 18 18 18 18 18 18 18 18 18 18 18 18 18 18 18 18 18 18 18 
0 0 0 0 0 0 0 0 28 18 28 29 29 28 18 18 18 29 29 29 18 0 0 0 0 0 0 0 0 0 0 0 0 0 0 0 0 0 0 0 0 0 0 28 0 0 0 0 0 0 0 0 0 0 29 28 18 29 29 29 29 29 29 29 29 29 29 29 29 29 29 29 29 29 29 29 18 29 29 29 29 29 29 29 29 29 28 0 0 0 0 0 0 0 0 0 0 0 0 0 0 0 0 0 0 0 0 0 0 0 0 0 0 0 0 0 0 0 0 0 0 0 0 0 0 0 0 0 0 0 0 0 0 0 0 0 0 0 0 0 0 0 30 29 30 29 30 29 30 29 30 29 30 29 30 29 30 29 30 29 30 29 30 
0 0 0 0 0 0 0 0 28 18 28 29 29 29 29 29 29 29 29 29 18 0 0 0 0 0 0 0 0 0 0 0 0 0 0 18 18 18 18 18 18 28 28 28 28 28 18 28 28 28 28 0 0 0 29 28 29 29 29 29 29 29 29 29 29 29 29 29 29 29 29 29 29 29 29 29 29 29 29 29 29 29 29 29 29 29 28 0 0 0 0 0 0 0 0 0 0 0 0 0 0 0 0 0 0 0 0 0 0 0 0 0 0 0 0 0 0 0 0 0 0 0 0 0 0 0 0 0 0 0 0 0 0 0 0 0 0 0 0 0 0 0 30 29 30 29 30 29 30 29 30 29 30 29 30 29 30 29 30 29 30 29 30 0 0 
0 0 0 0 0 0 0 0 18 18 28 29 29 29 29 29 29 29 28 28 18 0 0 0 0 0 0 0 0 0 0 0 0 0 0 29 29 29 29 29 29 0 0 0 0 28 18 28 28 28 28 0 0 0 29 28 29 29 29 29 29 29 29 29 29 29 29 29 29 29 29 29 18 29 29 29 29 29 29 29 29 29 29 29 29 29 28 0 0 0 0 0 0 0 0 0 0 0 0 0 0 0 0 0 0 0 0 0 0 0 0 0 0 0 0 0 0 0 0 0 0 0 0 0 0 0 0 0 0 0 0 0 0 0 0 0 0 0 0 0 0 0 30 29 30 29 30 29 30 29 30 29 30 29 30 29 30 29 30 29 30 29 30 
0 0 0 0 0 0 0 0 28 18 28 29 29 29 29 29 29 29 28 18 18 0 0 0 0 0 0 0 0 0 0 0 0 0 0 29 29 29 29 29 29 0 0 0 0 0 29 18 18 18 18 0 0 0 29 28 18 29 29 29 29 29 29 29 29 29 29 29 29 29 29 29 29 29 29 29 29 29 29 29 29 29 29 29 29 29 28 0 0 0 0 0 0 0 0 0 0 0 0 0 0 0 0 0 0 0 0 0 0 0 0 0 0 0 0 0 0 0 0 0 0 0 0 0 0 0 0 0 0 0 0 0 0 0 0 0 0 0 0 0 0 0 30 29 30 29 30 29 30 29 30 29 30 29 30 29 30 29 30 29 30 29 30 
0 0 0 0 0 0 0 0 28 18 28 29 29 28 28 28 28 28 18 18 18 0 0 0 0 0 0 0 0 0 0 0 0 0 0 0 0 0 0 0 0 0 0 0 0 0 29 29 29 29 29 0 0 0 29 28 18 29 29 29 29 29 29 29 29 29 29 29 29 29 29 29 29 29 29 29 29 29 29 29 29 29 29 29 29 29 18 0 0 0 0 0 0 0 0 0 0 0 0 0 0 0 0 0 0 0 0 0 0 0 0 0 0 0 0 0 0 0 0 0 0 0 0 0 0 0 0 0 0 0 0 0 0 0 0 0 0 0 0 0 0 0 30 29 30 29 30 29 30 29 30 29 18 29 30 29 30 29 30 29 30 29 30 0 0 0 
0 0 0 0 0 0 0 0 18 18 28 29 29 28 18 18 18 18 18 18 18 0 0 0 0 0 0 0 0 0 0 0 0 0 0 0 0 0 0 0 0 0 0 0 0 0 0 29 29 29 29 0 0 0 18 28 18 18 29 29 29 29 29 29 29 29 29 29 29 29 29 29 29 29 29 29 2 29 29 29 29 29 29 29 29 29 28 0 0 0 0 0 0 0 0 0 0 0 0 0 0 0 0 0 0 0 0 0 0 0 0 0 0 0 0 0 0 0 0 0 0 0 0 0 0 0 0 0 0 0 0 0 0 0 0 0 0 0 0 0 0 0 30 29 30 29 30 29 30 29 30 18 18 18 30 29 30 29 30 29 30 29 30 
0 0 0 0 0 0 0 0 28 18 28 29 29 29 29 29 29 29 29 29 28 0 0 0 0 0 0 0 0 0 0 0 0 0 0 0 0 0 0 0 0 0 0 0 0 0 0 0 0 0 0 0 0 0 29 28 18 18 29 29 29 29 29 29 29 29 18 29 29 29 29 29 29 29 29 29 2 2 29 29 29 29 29 29 29 29 18 0 0 0 0 0 0 0 0 0 0 0 0 0 0 0 0 0 0 0 0 0 0 0 0 0 0 0 0 0 0 0 0 0 0 0 0 0 0 0 0 0 0 0 0 0 0 0 0 0 0 0 0 0 0 0 30 29 30 29 30 29 30 29 18 18 18 18 18 29 30 29 30 29 30 29 30 
0 0 0 0 0 0 0 0 28 18 28 29 29 29 29 29 29 29 29 29 28 0 0 0 0 0 0 0 0 0 0 0 0 0 0 0 0 0 0 0 0 0 0 0 0 0 0 0 0 0 0 0 0 0 29 28 18 18 18 18 18 18 18 18 18 18 18 18 18 18 18 18 18 28 28 28 18 18 18 18 18 18 18 18 18 18 18 28 28 28 18 18 18 18 18 18 18 18 18 18 18 18 18 18 28 28 28 28 18 18 18 18 18 18 18 18 18 18 18 18 18 18 18 18 18 18 18 18 18 18 18 18 18 18 18 18 18 18 18 18 18 18 18 18 18 18 18 18 18 18 18 18 18 18 18 18 18 18 18 18 18 18 18 18 18 18 18 18 18 18 18 18 18 18 18 18 18 18 18 18 18 18 18 18 18 18 18 18 18 18 18 18 18 18 18 18 18 18 18 18 18 18 18 18 18 18 18 0 0 0 0 0 29 29 29 0 0 0 0 29 29 29 0 0 0 29 29 29 0 0 0 29 29 29 0 0 29 29 29 
0 0 0 0 0 0 0 0 18 18 18 29 29 29 29 29 29 29 29 29 28 0 0 0 0 0 0 0 0 0 0 0 0 0 0 0 0 0 0 0 0 0 0 0 0 0 0 0 0 0 0 0 0 0 18 28 28 28 28 28 28 28 28 28 28 28 28 28 18 29 29 29 29 29 29 29 29 29 29 29 29 0 0 0 0 0 0 0 0 0 28 28 28 28 28 28 28 28 28 28 28 28 28 28 0 0 0 0 28 28 28 28 28 28 28 28 28 28 28 28 28 28 28 28 28 28 28 28 28 28 28 28 28 28 28 28 28 28 28 28 28 28 28 28 28 28 28 28 28 28 28 28 28 28 28 28 28 28 28 28 28 28 28 28 28 28 28 28 28 28 28 28 28 28 28 28 28 28 28 28 28 28 28 28 28 28 28 28 28 28 28 28 28 28 28 28 28 28 28 28 28 28 28 28 28 28 28 0 0 0 0 0 5 5 29 0 0 0 0 5 5 29 0 0 0 5 5 29 0 0 0 5 5 29 0 0 5 5 29 
0 0 0 0 0 0 0 0 28 28 28 29 29 29 29 29 29 29 29 29 28 0 0 0 0 0 0 0 0 0 0 0 0 0 0 0 0 0 0 0 0 0 0 0 0 0 0 0 0 0 0 0 0 0 29 28 28 28 28 28 28 28 28 28 28 28 28 28 18 29 29 29 29 29 29 29 29 29 29 29 29 0 0 0 0 0 0 0 0 0 0 0 0 0 0 0 0 0 0 0 0 0 0 0 0 0 0 0 0 0 0 0 0 0 0 0 0 0 0 0 0 0 0 0 0 0 0 0 0 0 0 0 0 0 0 0 0 0 0 0 0 0 0 0 0 0 0 0 0 0 0 0 0 0 0 0 0 0 0 0 0 0 0 0 0 0 0 0 0 0 0 0 0 0 0 0 0 0 0 0 0 0 0 0 0 0 0 0 0 0 0 0 0 0 0 0 0 0 0 0 0 0 0 0 0 0 0 0 0 0 0 0 5 5 29 0 0 0 0 5 5 29 0 0 0 5 5 29 0 0 0 5 5 29 0 0 5 5 29 
0 0 0 0 0 0 0 0 28 18 18 18 18 18 18 18 18 18 18 18 18 18 18 18 18 18 18 18 18 18 18 18 18 18 0 0 0 0 0 0 0 0 0 0 0 0 0 0 0 0 0 0 0 0 18 18 18 18 18 18 18 18 18 18 18 18 18 18 18 29 29 29 29 1 29 29 29 29 29 29 29 0 0 0 0 0 0 0 0 0 0 0 0 0 0 0 0 0 0 0 0 0 18 18 18 18 18 18 
0 0 0 0 0 0 18 18 18 18 28 28 28 28 28 28 28 28 28 28 28 28 28 28 28 28 28 28 28 28 28 28 28 28 0 0 0 0 0 0 0 0 0 0 0 0 0 0 0 0 0 0 0 0 28 28 28 28 28 28 28 18 29 29 29 29 29 29 29 29 29 29 29 1 1 29 29 29 29 29 29 0 0 0 0 0 0 0 0 0 0 0 0 0 0 0 0 0 0 0 0 18 28 28 28 28 18 0 0 0 0 0 0 0 0 0 0 0 0 0 0 0 0 0 0 0 0 0 0 0 0 0 0 0 0 0 0 0 0 0 0 0 0 0 0 0 0 0 0 0 0 0 0 0 0 0 0 0 0 0 0 0 0 0 0 0 0 0 0 0 0 0 0 0 0 0 0 0 0 0 0 0 0 0 0 0 0 0 0 0 0 0 0 0 0 0 0 0 0 0 0 0 0 0 0 0 0 0 0 0 0 0 0 0 0 0 0 0 0 0 0 0 0 0 0 0 0 0 0 0 0 0 0 0 0 0 0 0 0 0 0 2 29 29 
0 0 0 0 0 0 0 0 0 18 28 29 29 29 29 29 29 29 29 29 29 29 29 29 29 29 29 29 29 29 29 29 29 29 0 0 0 0 0 0 0 0 0 0 0 0 0 0 0 0 0 0 0 0 29 29 29 29 29 29 28 18 29 29 29 29 29 29 29 29 29 29 18 18 18 18 18 18 18 18 29 0 0 0 0 0 0 0 0 0 0 0 0 0 0 0 0 0 0 0 18 28 29 29 28 18 0 0 0 0 0 0 0 0 0 0 0 0 0 0 0 0 0 0 0 0 0 0 0 0 0 0 0 0 0 0 0 0 0 0 0 0 0 0 0 0 0 0 0 0 0 0 0 0 0 0 0 0 0 0 0 0 0 0 0 0 0 0 0 0 0 0 0 0 0 0 0 0 0 0 0 0 0 0 0 0 0 0 0 0 0 0 0 0 0 0 0 0 0 0 0 0 0 0 0 0 0 0 0 0 0 0 0 0 0 0 0 0 0 0 0 0 0 0 0 0 0 0 0 0 0 0 0 0 0 0 0 0 0 0 0 5 5 5 
0 0 0 0 0 0 0 0 0 18 28 29 29 29 29 29 29 29 29 29 29 29 29 29 29 29 29 29 29 29 29 29 29 29 0 0 0 18 28 28 28 18 0 0 0 0 0 0 0 0 0 0 0 0 0 0 0 0 0 0 28 18 29 29 29 29 29 29 29 29 29 18 29 29 29 29 29 29 29 18 29 0 0 0 0 0 0 0 0 0 0 0 0 0 0 0 0 0 0 18 28 29 29 28 18 0 0 0 0 0 0 0 0 0 0 0 0 0 0 0 0 0 0 0 0 0 0 0 0 0 0 0 0 0 0 0 0 0 0 0 0 0 0 0 0 0 0 0 0 0 0 0 0 0 0 0 0 0 0 0 0 0 0 0 0 0 0 0 0 0 0 0 0 0 0 0 0 0 0 0 0 0 0 0 0 0 0 0 0 0 0 0 0 0 0 0 0 0 0 0 0 0 0 0 0 0 0 0 0 0 0 0 0 0 0 0 0 0 0 0 0 0 0 0 0 0 0 0 0 0 0 0 0 0 0 0 0 0 0 0 0 5 5 5 
0 0 0 0 0 0 0 0 0 18 28 29 29 29 29 29 29 29 29 29 29 29 29 29 29 29 29 29 29 29 29 29 29 29 0 0 18 18 28 28 28 18 18 0 0 0 0 0 0 0 0 0 0 0 0 0 0 0 0 0 28 18 29 29 29 29 29 29 29 29 18 18 29 29 29 29 29 29 29 18 29 0 0 0 0 0 0 0 0 0 0 0 0 0 0 0 0 0 18 28 29 29 28 28 0 0 0 0 0 0 0 0 0 0 0 16 0 0 0 16 0 0 0 16 0 0 0 16 0 0 0 16 0 0 0 0 0 0 0 0 0 0 0 0 0 0 0 0 0 0 0 0 0 0 0 0 0 0 0 0 0 0 0 0 0 0 0 0 0 0 0 0 0 0 0 0 0 0 0 0 0 0 0 0 0 0 0 0 0 0 0 0 0 0 0 0 0 0 0 0 0 0 0 0 0 0 0 0 0 0 0 0 0 0 0 0 0 0 0 0 0 0 0 0 0 0 0 0 0 0 0 0 0 0 0 0 29 2 29 0 0 5 5 5 
0 0 0 0 0 0 0 0 0 18 28 29 29 29 29 29 29 29 29 29 29 29 29 29 29 29 29 29 29 29 29 29 29 29 0 18 18 28 28 28 28 28 18 18 0 0 0 0 0 0 0 0 0 0 0 0 0 0 0 0 28 18 29 29 29 29 29 29 29 18 18 29 29 29 29 29 29 29 29 18 2 0 0 0 0 0 0 0 0 0 0 0 0 0 0 0 0 18 28 29 29 28 18 0 0 0 0 0 0 0 0 0 16 0 0 16 0 0 0 16 0 0 0 16 0 0 0 16 0 0 0 16 0 0 0 0 0 0 0 0 0 0 0 0 0 0 0 0 0 0 0 0 0 0 0 0 0 0 0 0 0 0 0 0 0 0 0 0 0 0 0 0 0 0 0 0 0 0 0 0 0 0 0 0 0 0 0 0 0 0 0 0 0 0 0 0 0 0 0 0 0 0 0 0 0 0 0 0 0 0 0 0 0 0 0 0 0 0 0 0 0 0 0 0 0 0 0 0 0 0 0 0 0 0 0 0 5 5 29 
0 0 0 0 0 0 0 0 0 18 28 29 29 29 29 29 29 29 29 29 29 29 29 29 29 29 29 29 29 29 29 29 29 29 18 18 28 28 0 0 0 28 28 18 18 0 0 0 0 0 0 0 0 0 0 0 0 0 0 0 28 18 29 29 29 29 29 29 29 29 29 29 29 29 29 29 29 29 29 18 2 2 0 0 0 0 0 0 0 0 0 0 0 0 0 0 18 28 29 29 28 18 0 0 0 0 0 0 0 16 0 0 16 0 0 0 0 0 0 0 0 0 0 0 0 0 0 0 0 0 0 0 0 0 0 0 0 0 0 0 0 0 0 0 0 0 0 0 0 0 0 0 0 0 0 0 0 0 0 0 0 0 0 0 0 0 0 0 0 0 0 0 0 0 0 0 0 0 0 0 0 0 0 0 0 0 0 0 0 0 0 0 0 0 0 0 0 0 0 0 0 0 0 0 0 0 0 0 0 0 0 0 0 0 0 0 0 0 0 0 0 0 0 0 0 0 0 0 0 0 29 29 29 0 0 0 5 5 29 
0 0 0 0 0 0 0 0 0 18 28 29 29 18 18 18 18 18 28 28 18 18 28 29 28 18 18 28 29 29 29 28 18 18 18 28 28 0 0 0 0 0 28 28 18 18 18 0 0 0 0 0 18 18 0 0 0 0 0 18 18 18 29 29 29 29 18 29 29 29 29 29 29 29 29 29 29 29 29 18 2 2 0 0 0 0 0 0 0 0 0 0 0 0 0 18 28 29 29 28 18 0 0 0 16 16 16 0 0 16 0 0 0 0 0 0 0 0 0 0 0 0 0 0 0 0 0 0 0 0 0 0 0 0 0 0 0 0 0 0 0 0 0 0 0 0 0 0 0 0 0 0 0 0 0 0 0 0 0 0 0 0 0 0 0 0 0 0 0 0 0 0 0 0 0 0 0 0 0 0 0 0 0 0 0 0 0 0 0 0 0 0 0 0 0 0 0 0 0 0 0 0 0 0 0 0 0 0 0 0 0 0 0 0 0 0 0 0 0 0 0 0 0 0 0 0 0 0 0 0 5 5 29 
0 0 0 0 0 0 0 0 0 18 28 29 29 29 29 29 29 29 29 29 29 29 29 29 29 29 29 29 29 29 29 29 29 29 29 28 0 0 0 0 0 0 0 28 28 28 28 0 0 0 0 0 28 28 0 0 0 0 0 28 28 28 29 29 29 29 18 18 29 29 29 29 29 29 29 29 29 29 29 18 2 2 2 28 28 28 28 28 28 28 28 28 28 28 28 28 28 28 28 18 0 0 0 0 0 0 16 
0 0 0 0 0 0 0 0 0 18 18 28 29 29 29 29 29 29 29 29 29 29 29 29 29 29 29 29 29 29 29 29 29 29 29 28 0 0 0 0 0 0 0 0 0 0 0 0 0 0 0 0 0 0 0 0 0 0 0 0 0 0 29 29 29 29 29 18 18 18 18 18 18 18 29 29 29 18 18 18 18 18 18 18 18 18 18 18 18 18 18 18 18 18 18 18 18 18 18 0 0 0 0 0 0 0 0 0 0 0 0 0 0 0 0 0 0 0 0 0 0 0 0 0 0 0 0 0 0 0 0 0 0 0 0 0 0 0 0 0 0 0 0 0 0 0 0 0 0 0 0 0 0 0 0 0 0 0 0 0 0 0 0 0 0 0 0 0 0 0 0 0 0 0 0 0 0 0 0 0 0 0 0 0 0 0 0 0 0 0 0 0 0 0 0 0 0 0 0 0 0 0 0 0 0 0 0 0 0 0 0 0 0 0 0 0 0 0 0 0 0 0 6 6 6 6 
0 0 0 0 0 0 0 0 0 18 28 29 29 29 29 29 29 29 29 29 29 29 29 29 29 29 29 29 29 29 29 29 29 29 29 28 0 0 0 0 0 0 0 0 0 0 0 0 0 0 0 0 0 0 0 0 0 0 0 0 0 0 29 29 29 29 29 29 29 29 29 29 29 29 29 29 29 29 29 29 0 0 0 0 0 0 0 0 0 0 0 0 0 0 0 0 0 0 0 0 0 0 0 0 0 0 0 0 0 0 0 0 0 0 0 6 0 0 0 0 0 0 0 0 0 0 0 0 0 0 0 0 0 0 0 0 0 0 0 0 0 0 0 0 0 0 0 0 0 0 0 0 0 0 0 0 0 0 0 0 0 0 0 0 0 0 0 0 0 0 0 0 0 0 0 0 0 0 0 0 0 0 0 0 0 0 0 0 0 0 0 0 0 0 0 0 0 0 0 0 0 0 0 0 0 0 0 0 0 0 0 0 0 0 0 0 0 0 6 6 6 6 6 6 6 6 6 
0 0 0 0 0 0 0 0 0 18 28 29 29 29 29 29 29 29 29 29 29 29 29 29 29 29 29 29 29 29 29 29 29 29 29 28 0 0 0 0 0 0 0 0 0 0 0 0 0 0 0 0 0 0 0 0 0 0 0 0 0 0 29 29 29 29 29 29 29 29 29 29 29 29 29 29 29 29 29 29 0 0 0 0 0 0 0 0 0 0 0 0 0 0 0 0 0 0 0 0 0 0 0 0 0 0 0 0 0 0 0 0 0 6 6 6 0 0 0 0 0 0 0 0 0 0 0 0 0 0 0 0 0 0 0 0 0 0 0 0 0 0 0 0 0 0 0 0 0 0 0 0 0 0 0 0 0 0 0 0 0 0 0 0 0 0 0 0 0 0 0 0 0 0 0 0 0 0 0 0 0 0 0 0 0 0 0 0 0 0 0 0 0 0 0 0 0 0 0 0 0 0 0 0 0 0 0 0 0 0 0 0 0 0 0 0 0 0 6 6 6 6 29 29 29 29 6 6 
0 0 0 0 0 0 0 0 0 18 18 28 29 29 29 29 29 29 29 29 29 28 29 29 29 29 29 29 29 29 29 29 29 29 29 28 0 0 0 0 0 0 0 0 0 0 0 0 0 0 0 0 0 0 0 0 0 0 0 0 0 0 29 29 29 29 29 29 29 29 29 29 29 29 29 29 1 29 29 29 0 0 0 0 0 0 0 0 0 0 0 0 0 0 0 0 0 0 0 0 0 0 0 0 0 0 0 0 0 0 0 0 0 6 6 6 0 0 0 0 0 0 0 0 0 0 0 0 0 0 0 0 0 0 0 0 0 0 0 0 0 0 0 0 0 0 0 0 0 0 0 0 0 0 0 0 0 0 0 0 0 0 0 0 0 0 0 0 0 0 0 0 0 0 0 0 0 0 0 0 0 0 0 0 0 0 0 0 0 0 0 0 0 0 0 0 0 0 0 0 0 0 0 0 0 0 0 0 0 0 0 0 0 0 0 6 6 6 6 6 6 29 29 29 29 29 29 6 6 6 
0 0 0 0 0 0 0 0 0 18 18 18 28 29 29 29 29 29 29 29 28 18 28 29 29 29 29 29 29 29 29 29 29 29 29 28 0 0 0 0 0 0 0 0 0 0 0 0 0 0 0 0 0 0 0 0 0 0 0 0 0 0 28 28 28 28 18 18 18 18 18 18 18 18 18 18 18 18 18 18 0 0 0 0 0 0 0 0 0 0 0 0 0 0 0 0 0 0 0 0 0 0 0 0 0 6 6 0 0 0 0 0 6 6 6 6 6 0 0 0 0 0 0 0 0 0 0 0 0 0 0 0 0 0 0 0 0 0 0 0 0 0 0 0 0 0 0 0 0 0 0 0 0 0 0 0 0 0 0 0 0 0 0 0 0 0 0 0 0 0 0 0 0 0 0 0 0 0 0 0 0 0 0 0 0 0 0 0 0 0 0 0 0 0 0 0 0 0 0 0 0 0 0 0 0 0 0 0 0 0 0 0 2 0 0 6 6 6 6 29 29 29 29 29 29 29 29 29 6 6 6 
0 0 0 0 0 0 0 0 0 18 18 18 18 18 18 18 18 18 18 18 18 18 18 18 18 18 18 18 18 18 18 29 29 29 29 18 0 0 0 0 0 0 0 0 0 0 0 0 0 0 0 0 0 0 0 0 6 6 0 0 0 0 0 0 0 0 0 0 0 0 0 0 0 0 0 0 0 0 0 0 0 0 0 0 0 0 0 0 0 0 0 0 0 0 0 6 6 6 30 6 30 6 30 6 30 6 6 6 6 6 29 29 29 29 6 6 6 0 0 0 0 0 0 0 0 0 0 0 0 0 0 0 0 0 0 0 0 0 0 0 0 0 0 0 0 0 0 0 0 0 0 0 0 0 0 0 0 0 0 0 0 0 0 0 0 0 0 0 0 0 0 0 0 0 0 0 0 0 0 0 0 0 0 0 0 0 0 0 0 0 0 0 0 0 0 0 0 0 0 0 0 0 6 6 0 0 0 0 0 0 0 0 6 6 6 6 6 6 29 29 29 29 29 29 29 29 29 29 29 29 29 
0 0 0 0 0 0 0 0 0 29 29 29 29 29 29 29 29 29 29 29 29 29 29 29 29 29 29 29 29 29 29 29 29 29 18 18 18 0 0 0 0 0 0 0 0 0 0 0 0 0 0 0 0 0 0 6 6 6 6 0 0 0 0 0 0 0 0 0 0 0 0 0 0 0 0 0 0 0 0 0 0 0 0 0 0 0 0 0 0 0 0 0 6 6 6 6 6 6 30 29 30 29 30 29 30 6 6 6 6 6 6 6 6 29 29 6 6 6 29 29 29 29 6 6 6 29 29 29 6 6 29 29 29 6 6 6 6 6 6 6 29 29 29 6 29 29 29 29 29 0 0 0 0 0 0 0 0 0 0 0 0 0 0 0 0 0 0 0 0 0 0 0 0 0 0 0 0 0 0 0 0 0 0 0 0 0 0 0 0 0 0 0 0 0 0 0 0 0 0 0 6 6 6 6 0 0 0 0 0 0 0 0 6 6 6 6 6 29 29 29 29 29 29 6 29 29 29 29 29 29 29 0 0 0 6 6 6 6 6 29 29 29 29 29 
0 0 0 0 0 0 0 0 0 29 29 29 29 29 29 29 29 29 29 29 29 29 29 29 29 29 29 29 29 29 29 29 29 18 18 28 18 18 0 0 0 0 0 0 0 0 0 0 0 0 0 0 0 0 0 6 6 6 6 6 0 0 0 0 0 0 0 0 0 0 0 0 0 0 0 0 0 0 0 0 0 0 0 0 0 0 0 0 0 0 0 0 6 6 6 6 6 6 30 29 30 29 30 29 30 6 6 6 6 6 6 6 6 6 29 6 6 6 29 29 29 29 6 6 6 29 29 29 6 6 29 29 29 6 6 6 6 6 6 6 29 29 29 29 29 29 29 6 29 0 0 0 0 0 0 0 0 0 0 0 0 0 0 0 0 0 0 0 0 0 0 0 0 0 0 0 0 0 0 0 0 0 0 0 0 0 0 0 0 0 0 0 0 0 0 0 0 0 0 6 6 6 6 6 0 0 0 0 0 0 0 0 29 29 29 6 6 29 29 29 29 6 6 6 29 29 29 29 29 29 29 0 0 6 6 6 6 6 6 29 29 29 29 29 
0 0 0 0 0 0 0 0 0 29 29 29 29 29 29 29 29 29 29 29 29 29 29 29 29 29 29 29 29 29 29 29 18 18 28 28 28 18 18 0 0 0 0 0 0 0 0 0 0 0 0 0 0 0 6 6 6 29 29 29 29 29 29 6 0 0 0 0 0 0 0 0 0 0 0 0 0 0 0 0 0 0 0 0 0 0 0 0 0 0 0 0 6 6 6 6 6 6 30 29 30 29 30 29 30 6 6 6 6 6 6 6 6 6 29 6 6 6 29 29 29 29 6 6 6 29 29 29 6 6 29 29 29 6 6 6 6 6 6 6 29 29 29 29 29 29 6 6 2 29 29 29 29 29 29 29 29 29 29 29 29 29 0 0 0 0 0 0 0 0 0 0 0 0 0 0 0 0 0 0 0 0 0 0 0 0 0 0 0 0 0 0 0 0 0 0 0 6 6 6 6 6 6 6 0 0 6 6 6 0 0 0 6 6 29 6 6 29 29 29 6 6 6 6 29 29 29 29 29 29 29 6 6 6 6 29 29 29 6 6 29 29 29 6 
0 0 0 0 0 0 0 0 0 29 29 29 29 29 29 29 29 29 29 29 29 29 29 29 29 29 29 29 29 29 29 18 18 28 28 28 28 28 18 18 0 0 0 0 0 0 0 0 0 0 0 0 0 29 29 29 29 29 6 29 29 29 6 6 0 0 0 0 0 0 0 6 6 6 0 0 0 0 0 0 0 0 0 0 0 0 0 0 0 0 6 6 6 6 6 6 6 6 30 29 30 29 30 29 30 6 6 6 6 6 6 6 6 29 29 6 6 6 29 29 29 29 6 6 6 29 29 29 6 6 29 29 29 6 6 6 6 6 6 6 29 29 29 29 29 6 6 33 6 6 29 29 29 29 29 29 29 29 29 29 29 29 6 6 6 29 29 29 29 6 6 6 6 6 6 6 6 29 29 29 29 29 29 29 29 29 29 29 29 6 6 0 0 0 0 0 0 6 6 6 6 6 6 6 0 0 0 0 0 0 0 0 6 6 29 29 29 29 29 6 6 6 6 6 6 29 29 29 29 29 29 6 6 29 29 29 29 29 29 6 6 29 29 6 
0 0 0 0 0 0 0 0 0 29 29 29 29 29 29 29 29 29 29 29 29 29 29 29 29 29 29 29 29 29 18 18 28 28 28 28 28 28 28 18 18 6 0 0 0 0 0 0 0 0 0 0 6 6 6 6 6 6 6 33 33 33 6 6 0 0 0 0 0 6 6 6 6 6 6 0 0 0 0 0 0 0 0 0 0 0 0 0 0 0 6 6 6 6 6 6 6 6 30 29 30 29 30 29 30 6 6 29 29 29 29 29 29 29 29 29 29 29 29 29 29 2 6 6 6 2 29 2 6 6 29 29 29 29 29 29 29 29 29 29 29 29 29 29 6 6 33 33 33 6 6 6 29 29 29 29 29 29 29 29 6 6 6 6 6 29 29 29 29 6 6 6 6 6 6 6 6 6 29 29 29 29 29 29 29 29 29 6 6 6 6 6 6 0 0 6 6 6 6 6 6 6 6 6 0 0 0 0 0 0 0 0 6 6 6 6 29 29 6 6 6 21 21 21 6 6 6 6 6 6 6 6 29 29 29 29 29 29 29 29 29 29 6 6 
0 0 0 0 0 0 0 0 0 18 18 18 18 18 18 18 18 18 18 18 18 18 18 18 18 18 18 18 18 18 18 18 28 28 28 28 28 28 28 28 18 18 6 0 0 0 0 0 0 0 6 6 6 6 6 6 6 6 6 33 33 6 6 6 2 0 0 0 6 6 6 6 6 6 6 2 0 0 0 0 0 0 0 0 0 0 0 0 2 29 29 29 29 29 29 29 29 29 29 29 29 29 29 29 29 6 29 29 6 6 6 6 6 6 6 6 6 6 6 6 6 6 6 6 6 6 6 6 6 6 6 6 6 6 6 6 6 6 6 6 6 6 6 6 6 6 33 33 33 33 33 6 6 6 6 29 6 6 29 29 6 6 6 6 6 29 29 29 29 6 6 6 6 6 6 6 6 6 6 6 6 33 33 6 6 33 33 6 6 6 6 6 6 6 6 6 6 6 6 6 6 6 6 6 0 0 0 0 0 0 0 6 6 6 6 29 29 29 29 6 21 21 21 21 21 21 6 6 6 6 6 29 29 29 29 29 29 29 29 29 29 29 6 6 
4 4 4 4 4 4 4 4 4 4 4 4 4 4 4 4 4 4 4 4 4 4 4 4 4 4 4 18 6 6 6 28 28 28 6 6 6 6 6 6 6 18 18 6 6 6 6 6 6 6 6 6 6 6 6 6 6 6 6 33 33 6 6 6 6 6 6 6 6 6 6 6 6 6 6 6 6 6 6 6 6 6 6 6 6 6 6 6 6 6 6 6 6 6 6 6 6 6 6 33 33 33 33 33 33 6 6 6 6 6 6 6 6 6 6 6 6 6 6 6 6 6 6 6 6 6 6 6 6 6 6 6 6 6 6 6 6 6 6 6 6 6 6 6 6 33 33 33 33 33 33 33 6 6 6 33 6 6 33 33 6 6 6 6 6 33 33 33 33 6 6 6 6 6 6 6 6 6 6 6 6 33 33 6 6 33 33 6 6 6 6 6 6 6 6 6 6 6 6 6 6 6 6 6 33 33 33 33 33 33 33 6 6 6 6 6 6 6 6 21 21 21 21 21 21 21 21 21 6 6 6 6 6 6 6 6 6 6 6 6 6 6 6 6 
