30 30 29 29 29 29 30 29 29 29 29 29 29 4 4 4 4 29 29 29 29 29 4 4 4 4 29 29 29 29 29 29 29 29 29 29 29 29 29 29 29 29 29 29 29 29 29 29 29 29 29 29 29 29 29 29 29 29 29 29 29 29 29 29 29 29 29 29 29 29 29 29 29 29 29 29 29 29 29 29 30 30 30 30 30 29 30 30 30 30 30 29 29 29 29 29 29 29 29 29 29 29 29 29 29 29 1 1 1 1 1 30 30 30 29 29 29 29 29 29 29 29 29 29 29 29 
30 30 29 29 29 29 30 29 29 29 29 29 29 4 4 4 4 29 29 29 29 29 4 4 4 4 29 29 29 29 29 30 30 30 30 30 30 30 30 30 30 30 30 30 30 30 30 30 30 30 30 30 30 30 30 30 30 30 30 30 30 30 30 30 30 30 29 29 29 29 29 29 29 29 29 29 29 29 29 29 29 30 30 30 29 29 29 30 30 30 29 29 29 29 29 29 29 29 29 29 29 29 29 29 29 1 1 1 1 1 1 1 30 30 30 29 29 29 29 29 29 29 29 29 29 29 
30 30 29 29 29 29 30 29 29 29 29 29 29 4 4 4 4 29 29 29 29 29 4 4 4 4 29 29 29 29 29 1 30 1 1 1 1 1 1 1 1 1 1 1 1 1 1 1 1 1 1 1 1 1 1 1 1 1 1 1 1 1 1 1 1 1 29 29 29 1 30 29 29 29 29 29 29 29 29 29 29 29 30 29 29 29 29 29 30 29 29 29 29 29 29 29 29 29 29 29 29 29 29 29 1 1 1 1 1 1 1 1 1 30 30 30 29 29 29 29 29 29 29 29 29 29 
30 30 29 29 29 29 30 29 29 29 29 29 29 29 29 29 29 29 29 29 29 29 29 29 29 29 29 29 29 29 29 1 29 29 29 29 29 29 29 29 29 29 29 29 18 30 30 30 30 30 30 30 30 30 30 30 30 30 30 30 30 30 29 29 29 29 29 29 29 1 30 30 29 29 29 29 29 29 29 29 29 29 29 29 29 29 29 29 29 29 29 29 29 29 29 29 29 29 29 29 1 1 1 1 1 1 1 1 1 1 1 1 1 1 30 30 30 29 29 29 29 29 29 29 29 29 
30 30 29 29 29 29 30 29 29 29 29 29 29 29 29 29 29 29 29 29 29 29 29 29 29 29 29 29 29 29 29 1 29 29 29 29 29 29 29 29 29 29 29 29 30 30 30 30 30 30 30 30 30 30 30 30 30 30 30 30 30 30 29 29 29 29 29 29 29 1 30 30 1 29 29 29 29 29 29 29 29 29 29 29 29 29 29 29 1 29 29 29 29 29 29 29 29 29 29 29 29 29 29 29 29 29 29 29 29 29 29 29 29 29 1 30 30 30 29 29 29 29 29 29 29 29 
30 30 29 29 29 29 30 29 29 29 29 29 29 29 29 29 29 29 29 29 29 29 29 29 29 29 29 29 29 29 29 1 29 29 29 29 29 29 29 29 29 29 29 29 30 30 30 30 30 30 30 30 30 30 30 30 30 30 30 30 30 30 29 29 29 29 29 29 3 1 30 30 30 1 29 29 29 29 29 29 29 29 29 29 29 29 29 1 1 1 29 29 29 29 29 29 29 29 29 29 29 29 29 29 29 29 29 29 29 29 29 29 29 29 29 1 30 30 30 29 29 29 29 29 29 29 
30 30 29 29 29 29 30 29 29 29 29 29 29 29 29 29 29 29 29 29 29 29 29 29 29 29 29 29 29 29 29 1 29 29 29 29 29 29 29 29 29 29 29 29 30 30 30 30 30 30 30 30 30 30 30 30 30 30 30 30 30 30 29 1 1 1 1 1 1 1 30 30 30 30 1 29 29 29 29 29 29 29 1 29 1 29 1 1 1 1 1 29 29 29 29 29 29 29 29 30 30 29 29 29 29 29 29 29 30 30 29 29 29 29 29 29 1 30 30 30 29 29 29 29 29 29 
1 1 29 29 29 29 1 1 1 1 1 1 1 1 1 1 1 1 1 1 1 1 1 1 1 1 1 1 1 1 1 1 29 29 29 29 29 29 29 29 29 29 29 29 30 30 30 30 30 30 30 30 30 30 30 30 30 30 30 30 30 30 18 29 29 29 29 29 29 1 30 30 30 30 30 1 30 30 30 30 30 1 1 1 1 1 1 1 1 1 1 1 29 29 29 29 29 29 30 30 30 30 29 29 29 29 29 30 30 30 30 29 29 29 29 29 29 1 30 30 30 29 29 29 29 29 
30 30 29 29 29 29 29 29 29 29 29 29 29 29 29 29 29 29 29 29 29 29 29 29 29 29 29 29 29 29 29 29 29 29 29 29 29 29 29 29 29 29 29 29 18 30 30 30 30 30 30 30 30 30 30 30 30 30 30 30 30 30 18 29 1 1 1 1 1 1 1 1 1 1 1 1 1 1 1 1 1 1 1 1 1 1 1 1 1 1 1 1 1 30 30 30 30 30 30 30 30 30 30 30 30 30 30 30 30 30 30 30 30 30 30 30 30 30 30 30 30 30 30 30 30 30 
30 30 29 29 29 29 29 29 29 29 29 29 29 29 29 29 29 29 29 29 29 29 29 29 29 29 29 29 29 29 29 29 29 18 29 18 18 29 18 29 29 29 29 29 18 30 30 30 30 30 30 30 30 30 30 30 30 30 30 30 30 30 29 29 1 29 29 29 1 29 29 29 1 29 29 29 1 29 29 29 1 1 1 1 1 1 1 1 1 1 1 1 1 1 1 1 1 1 1 1 1 1 1 1 1 1 1 1 1 1 1 1 1 1 1 1 1 1 30 30 30 30 30 30 30 30 
1 1 29 29 29 29 29 29 29 29 29 29 29 29 29 29 29 29 29 29 29 29 29 29 29 29 29 29 29 29 29 29 29 29 1 1 1 1 29 29 29 29 29 29 18 30 30 30 30 30 30 30 30 30 30 30 30 30 30 30 30 3 18 29 1 29 1 29 29 29 1 29 29 29 1 29 29 29 1 29 29 29 29 29 29 29 29 29 29 29 29 29 29 29 29 29 29 29 29 29 29 29 29 29 29 29 29 29 29 29 29 29 29 1 29 29 1 29 29 29 29 29 29 29 29 29 
30 30 29 29 29 29 29 29 29 29 29 29 29 29 29 29 29 29 29 29 29 29 29 29 29 29 29 29 29 29 29 29 29 18 29 18 18 29 18 29 29 29 29 29 18 1 1 1 1 1 1 1 1 1 1 1 1 1 1 1 1 1 1 29 1 29 29 29 1 29 29 29 1 29 29 29 1 29 29 29 1 29 29 1 29 29 1 29 29 1 29 29 1 29 29 1 29 29 1 29 29 1 29 29 1 29 29 1 29 29 29 29 29 1 29 29 29 1 29 29 29 29 29 29 29 29 
30 30 29 29 29 29 29 29 29 29 29 29 29 29 29 29 29 29 29 29 30 29 29 29 29 29 29 29 29 30 29 29 29 29 29 29 29 29 29 29 29 29 29 18 29 29 29 29 29 29 29 29 29 29 29 29 29 29 29 29 29 29 29 29 1 29 1 29 29 29 1 29 29 29 1 29 29 29 1 29 29 29 29 29 29 29 29 29 29 29 29 29 29 29 29 29 29 29 29 29 29 29 29 29 29 29 29 29 29 29 29 29 29 1 29 29 29 29 1 29 29 29 29 29 29 29 
1 1 29 29 29 29 29 29 29 29 29 29 29 29 29 29 29 29 29 30 1 30 29 29 29 29 29 29 30 1 30 29 29 29 29 29 29 29 29 29 29 29 18 29 29 29 1 1 1 1 1 1 1 1 1 1 1 1 1 1 1 1 1 1 1 29 29 29 1 29 29 29 1 29 29 29 1 1 1 1 1 1 1 1 1 1 1 1 1 1 1 1 1 1 1 1 1 1 1 1 1 1 1 1 1 1 1 1 1 1 1 1 1 1 29 29 29 29 29 1 29 29 29 29 29 29 
30 30 29 29 29 29 29 29 29 29 29 29 29 29 29 29 29 29 30 1 1 1 30 29 29 29 29 30 1 1 1 30 29 29 29 29 29 29 29 29 29 18 29 29 29 29 29 29 29 29 29 29 29 29 29 29 29 29 29 29 29 29 29 29 29 29 1 29 29 29 1 29 29 29 1 1 1 29 29 29 29 29 29 29 29 29 29 29 29 29 29 29 29 29 29 29 29 29 29 29 29 29 29 29 29 29 29 29 29 29 29 29 29 29 29 29 29 29 29 29 1 29 29 29 29 29 
30 30 29 29 29 1 29 29 29 29 29 29 29 29 29 29 29 30 1 1 1 1 1 30 29 29 30 1 1 1 1 1 30 29 29 29 29 29 29 29 1 1 1 1 1 1 1 1 1 1 1 1 1 1 1 1 1 1 1 1 1 1 1 1 1 1 1 1 1 1 1 1 1 1 1 29 29 29 29 29 29 29 29 29 29 29 29 29 29 29 29 29 29 29 29 29 29 29 29 29 29 29 29 29 29 29 29 29 29 29 29 29 29 29 29 29 29 29 29 29 29 1 29 29 1 1 
30 30 29 29 29 30 1 29 29 29 29 29 29 29 29 29 29 29 30 1 1 1 30 29 29 29 29 30 1 1 1 30 29 29 29 29 29 29 29 29 29 29 29 29 29 29 29 29 29 29 29 29 29 29 29 29 29 29 29 29 29 29 29 29 29 29 29 29 29 29 29 29 29 29 29 29 29 29 29 29 29 29 29 29 29 29 29 29 29 29 29 29 29 29 29 29 29 29 29 29 29 29 29 29 29 29 29 29 29 29 29 29 29 29 29 29 29 29 29 29 29 1 29 29 29 1 
1 1 29 29 29 30 30 1 29 29 29 29 29 29 29 29 29 29 29 30 1 30 29 29 29 29 29 29 30 1 30 29 29 29 29 29 29 29 29 29 29 29 29 29 29 29 29 29 29 29 29 29 29 29 29 29 29 29 29 29 29 29 29 29 29 29 29 29 29 29 29 29 29 29 29 29 29 29 29 29 29 29 29 29 29 29 29 29 29 29 29 29 29 29 29 29 29 29 29 29 29 29 29 29 29 29 29 29 29 29 29 29 29 29 29 29 29 29 29 29 29 1 29 29 29 1 
29 29 29 29 29 30 30 30 1 29 29 29 29 29 29 29 29 29 29 29 30 29 29 29 29 29 29 29 29 30 29 29 29 29 29 29 18 29 29 29 29 29 29 29 29 29 29 29 29 29 29 29 29 29 29 29 29 29 29 29 29 29 29 29 29 29 29 29 1 29 29 29 29 29 29 29 29 29 29 29 29 29 29 29 29 29 29 29 29 29 29 29 29 29 29 29 29 1 1 1 29 1 1 29 29 29 29 29 29 29 29 29 29 29 29 29 29 29 29 29 29 1 1 29 29 1 
29 29 29 29 29 29 30 30 30 1 29 29 29 29 29 29 29 29 29 29 29 29 29 29 30 30 29 29 29 29 29 29 29 29 29 18 30 18 29 29 29 29 29 29 29 29 29 29 29 29 29 29 29 29 29 29 29 29 29 29 29 29 29 29 29 29 29 1 29 29 29 29 29 29 29 18 29 29 29 29 29 29 29 29 29 29 29 29 29 29 29 29 29 29 29 29 29 29 29 29 29 29 29 29 29 29 29 29 29 29 29 29 29 29 29 29 29 29 29 29 29 1 29 29 29 1 
29 29 29 29 29 29 29 30 30 30 1 29 29 29 29 29 29 29 29 29 29 29 29 30 1 1 30 29 29 29 29 29 29 29 18 30 30 30 18 29 29 29 29 29 29 29 29 29 29 29 29 29 29 29 29 29 29 29 29 29 29 29 29 29 29 29 1 29 29 29 29 29 29 29 29 29 29 29 29 29 29 29 29 29 29 29 29 29 29 29 29 29 29 29 29 29 29 29 29 29 29 29 29 29 29 29 29 29 29 29 29 29 1 29 1 1 1 1 1 1 29 1 29 29 1 1 
29 29 29 29 29 29 29 29 30 30 30 1 29 29 29 29 29 29 29 29 29 29 30 1 1 1 1 30 29 29 29 29 29 18 30 30 30 30 30 30 29 29 29 29 29 29 29 29 29 29 29 29 29 29 29 29 29 29 29 29 29 29 29 29 29 1 29 29 29 29 29 29 29 1 1 1 1 1 1 1 1 1 1 29 29 29 29 1 1 1 1 1 1 1 29 29 29 29 29 29 29 29 29 29 29 29 1 29 29 29 29 29 1 29 1 29 29 29 29 29 29 1 29 29 29 1 
29 29 29 29 29 29 29 29 29 30 30 30 1 1 1 1 1 1 1 1 1 1 1 1 1 1 1 1 1 1 1 1 1 30 30 30 30 30 30 30 30 29 1 1 1 1 1 1 1 1 1 1 1 1 1 1 1 1 1 1 1 1 1 1 1 29 29 29 29 29 29 29 18 18 29 29 29 29 29 29 29 29 29 29 29 29 29 29 29 29 29 29 29 29 1 29 29 29 29 29 29 29 29 29 29 1 29 1 29 29 29 29 1 29 1 29 1 1 1 1 1 1 29 29 29 1 
29 29 29 29 29 29 29 29 29 29 30 30 18 29 29 29 29 29 29 29 29 29 29 29 29 29 29 29 29 29 29 29 29 29 29 29 29 29 29 29 29 18 18 18 18 18 18 18 18 18 18 18 18 18 18 18 18 18 18 18 18 18 18 18 1 29 29 29 29 29 29 18 1 29 29 29 29 29 29 29 29 29 29 29 29 29 29 29 29 29 29 29 29 29 29 1 29 29 29 29 29 29 29 29 1 29 29 1 29 29 29 29 1 29 1 29 29 29 29 29 29 1 1 29 29 1 
29 29 29 29 29 29 29 29 29 29 29 30 18 29 29 29 29 29 29 29 29 29 29 29 29 29 29 29 29 29 29 29 29 29 29 29 29 29 29 29 18 18 29 29 29 29 29 29 29 29 29 29 29 29 29 29 29 29 29 29 29 29 29 29 1 29 29 29 29 29 18 1 29 29 29 29 29 29 29 29 29 29 29 29 29 29 29 29 29 29 29 29 29 29 29 29 1 29 29 29 29 29 29 1 29 29 29 1 29 29 29 29 1 29 1 1 1 1 1 1 29 1 29 29 29 1 
29 29 29 29 29 29 29 29 29 29 29 29 30 29 29 29 29 29 29 29 29 29 29 29 29 29 29 29 29 29 29 29 29 29 29 29 29 29 29 29 29 29 29 29 29 29 29 29 29 29 29 29 29 29 29 29 29 29 29 29 29 29 29 29 1 29 29 29 29 18 1 29 29 29 29 29 29 29 29 1 1 29 29 29 29 29 29 29 29 29 29 29 29 29 29 29 29 1 29 29 29 29 1 29 29 29 29 1 5 29 29 29 1 29 1 29 29 29 29 29 29 1 29 29 29 1 
29 29 29 29 29 29 29 29 29 29 29 29 30 29 29 29 29 29 29 29 29 29 29 29 29 29 29 29 29 29 29 29 29 29 29 29 29 29 29 29 29 29 29 29 29 29 29 29 29 29 29 29 29 29 29 29 29 29 29 29 29 29 29 29 29 29 29 29 18 1 29 29 29 29 29 29 29 29 18 18 18 29 29 29 29 29 29 29 29 29 29 29 29 29 29 29 29 29 1 1 1 1 29 29 29 29 29 1 5 5 29 29 29 29 1 29 1 1 1 1 1 1 29 29 1 1 
29 29 29 29 29 29 29 29 29 29 29 29 30 29 29 29 29 29 29 29 29 29 29 29 29 29 29 29 29 29 29 29 29 29 29 29 29 1 29 29 29 29 29 29 29 29 29 29 29 29 29 29 29 29 29 29 29 29 29 29 29 29 29 29 29 29 29 29 29 18 29 29 29 29 29 29 29 1 1 1 1 1 29 29 29 29 29 29 29 29 29 29 29 29 29 29 29 29 29 29 29 29 29 29 29 29 29 1 1 1 1 1 1 29 1 29 29 29 29 29 29 29 29 1 1 1 
30 30 30 30 30 30 30 30 30 30 30 30 30 29 29 29 29 29 29 29 29 29 29 29 29 29 29 29 29 29 29 29 29 29 29 29 18 18 18 29 29 29 29 29 29 29 29 29 29 29 29 29 29 29 29 29 29 29 29 29 29 29 29 29 29 29 29 29 29 29 29 29 29 29 29 18 18 18 18 18 18 18 29 29 29 29 29 29 29 29 29 29 29 29 29 29 29 29 1 29 29 1 29 29 29 29 29 29 29 29 29 29 29 29 1 29 29 29 29 29 29 29 1 1 1 1 
18 18 18 18 18 18 18 18 18 18 18 30 1 1 1 1 1 1 1 1 1 1 1 1 1 1 1 1 1 1 1 1 1 1 1 1 1 1 1 1 1 1 1 1 1 1 1 1 1 1 1 1 1 1 1 1 1 1 1 1 1 1 1 1 1 1 1 1 1 1 1 1 1 1 1 1 1 1 1 1 1 1 1 29 29 29 29 1 1 1 1 1 1 1 1 1 1 1 1 1 1 1 1 1 1 1 1 1 1 1 1 1 1 1 1 1 1 1 1 1 1 1 1 1 1 1 
