0 
0 
0 
0 
0 
0 
0 
0 0 0 0 0 0 0 0 0 0 0 0 0 0 0 0 0 0 0 0 0 0 0 0 0 0 0 0 0 0 0 0 0 0 0 0 0 0 0 0 0 0 0 0 0 0 0 0 0 0 0 0 0 0 0 0 0 0 0 0 0 0 0 0 0 0 0 0 0 0 0 0 0 0 0 0 0 0 0 0 0 0 0 0 0 0 0 0 0 0 0 0 0 0 0 0 0 0 0 0 0 0 0 0 0 0 0 0 0 0 0 0 0 0 0 0 0 0 0 0 0 0 0 0 0 0 0 0 0 0 0 0 0 0 0 0 0 0 0 0 0 0 0 0 0 0 0 0 0 0 0 0 0 0 0 0 0 0 0 0 0 0 0 0 0 0 0 0 0 0 0 0 0 0 0 0 0 0 0 0 0 12 12 
0 0 0 0 0 0 0 0 0 0 0 0 0 0 0 0 0 0 0 0 0 0 0 0 0 0 0 0 0 0 0 0 0 0 0 0 0 0 0 0 0 0 0 0 0 0 0 0 0 0 0 0 0 0 0 0 0 0 0 0 0 0 0 0 0 0 0 0 0 0 0 0 0 0 0 0 0 0 0 0 0 0 0 0 0 0 0 0 0 0 0 0 0 0 0 0 0 0 0 0 0 0 0 0 0 0 0 0 0 0 0 0 0 0 0 0 0 0 0 0 0 0 0 0 0 0 0 0 0 0 0 0 0 0 0 0 0 0 0 0 0 0 0 0 0 0 0 0 0 0 0 0 0 0 0 0 0 0 0 0 0 0 0 0 0 0 0 0 0 0 0 0 0 0 0 0 0 0 0 0 12 12 12 12 
0 0 0 0 0 0 0 0 0 0 0 0 0 0 0 0 0 0 0 0 0 0 0 0 0 0 0 0 0 0 0 0 0 0 0 0 0 0 0 0 0 0 0 0 0 0 0 0 0 0 0 0 0 0 0 0 0 0 0 0 0 0 0 0 0 0 0 0 0 0 0 0 0 0 0 0 0 0 0 0 0 0 0 0 0 0 0 0 0 0 0 0 0 0 0 0 0 0 0 0 0 0 0 0 0 0 0 0 0 0 0 0 0 0 0 0 0 0 0 0 0 0 0 0 0 0 0 0 0 0 0 0 0 0 0 0 0 0 0 0 0 0 0 0 0 0 0 0 0 0 0 0 0 0 0 0 0 0 0 0 0 0 0 0 0 0 0 0 0 0 0 0 0 0 0 0 0 0 0 12 12 12 12 12 12 
0 0 0 0 0 0 0 0 0 0 0 0 0 0 0 0 0 0 0 0 0 0 0 0 0 0 0 0 0 0 0 0 0 0 0 0 0 0 0 0 0 0 0 0 0 0 0 0 0 0 0 0 0 0 0 0 0 0 0 0 0 0 0 0 0 0 0 0 0 0 0 0 0 0 0 0 0 0 0 0 0 0 0 0 0 0 0 0 0 0 0 0 0 0 0 0 0 0 0 0 0 0 0 0 0 0 0 0 0 0 0 0 0 0 0 0 0 0 0 0 0 0 0 0 0 0 0 0 0 0 0 0 0 0 0 0 0 0 0 0 0 0 0 0 0 0 0 0 0 0 0 0 0 0 0 0 0 0 0 0 0 0 0 0 0 0 0 0 0 0 0 0 0 0 0 0 0 0 12 12 12 12 12 12 12 12 
0 0 0 0 0 0 0 0 0 0 0 0 0 0 0 0 0 0 0 0 0 0 0 0 0 0 0 0 0 0 0 0 0 0 0 0 0 0 0 0 0 0 0 0 0 0 0 0 0 0 0 0 0 0 0 0 0 0 0 0 0 0 0 0 0 0 0 0 0 0 0 0 0 0 0 0 0 0 0 0 0 0 0 0 0 0 0 0 0 0 0 0 0 0 0 0 0 0 0 0 0 0 0 0 0 0 0 0 0 0 0 0 0 0 0 0 0 0 0 0 0 0 0 0 0 0 0 0 0 0 0 0 0 0 0 0 0 0 0 0 0 0 0 0 0 0 0 0 0 0 0 0 0 0 0 0 0 0 0 0 0 0 0 0 0 0 0 0 0 0 0 0 0 0 0 0 0 0 12 12 12 12 12 12 12 12 
0 0 0 0 0 0 0 0 0 0 0 0 0 0 0 0 0 0 0 0 0 0 0 0 0 0 0 0 0 0 0 0 0 0 0 0 0 0 0 0 0 0 0 0 0 0 0 0 0 0 0 0 0 0 0 0 0 0 0 0 0 0 0 0 0 0 0 0 0 0 0 0 0 0 0 0 0 0 0 0 0 0 0 0 0 0 0 0 0 0 0 0 0 0 0 0 0 0 0 0 0 0 0 30 30 30 30 30 30 30 30 30 0 0 0 0 0 0 0 0 0 0 0 0 0 0 0 0 0 0 0 0 0 0 0 0 0 0 0 0 0 0 0 0 0 10 10 10 10 10 0 0 0 0 0 0 0 0 10 0 0 0 0 0 0 0 0 0 0 0 0 0 0 0 0 0 0 0 12 28 28 28 28 28 28 12 12 
0 0 0 0 0 0 0 0 0 0 0 0 0 0 0 0 0 0 0 0 0 0 0 0 0 0 0 0 0 0 0 0 0 0 0 0 0 0 0 0 0 0 0 0 0 0 0 0 0 0 0 0 0 0 0 0 0 0 0 0 0 0 0 0 0 0 0 0 0 0 0 0 0 0 0 0 0 0 0 0 0 0 0 0 0 0 0 0 0 0 0 0 0 0 0 0 0 0 0 0 0 0 30 10 10 10 10 10 10 10 10 30 30 0 0 0 0 0 0 0 0 0 0 0 0 0 0 0 0 0 0 0 0 30 30 30 30 30 30 30 30 30 30 30 30 30 10 30 30 30 30 0 0 0 0 0 0 0 10 0 0 0 0 0 0 0 0 0 0 0 0 0 0 0 0 0 0 0 12 28 28 28 28 28 28 28 
0 0 0 0 0 0 0 0 0 0 0 0 0 0 0 0 0 0 0 0 0 0 0 0 0 0 0 0 0 0 0 0 0 0 0 0 0 0 0 0 0 0 0 0 0 0 0 0 0 0 0 0 0 0 0 0 0 0 0 0 0 0 0 0 0 0 0 0 0 0 0 0 0 0 0 0 0 0 0 0 0 0 0 0 0 0 0 0 0 0 0 0 0 0 0 0 0 0 0 0 0 30 10 10 0 0 0 0 0 0 10 10 30 0 0 0 0 0 0 0 0 0 0 0 0 0 0 0 0 0 0 0 0 30 10 10 10 10 10 30 30 30 30 30 30 30 10 30 30 30 30 0 0 0 0 0 0 0 10 0 0 0 0 0 0 0 0 0 0 0 0 0 0 0 0 0 0 0 12 28 28 28 28 28 28 28 
0 0 0 0 0 0 0 0 0 0 0 0 0 0 0 0 0 0 0 0 0 0 0 0 0 0 0 0 0 0 0 0 0 0 0 0 0 0 0 0 0 0 0 0 0 0 0 0 0 0 0 0 0 0 0 0 0 0 0 0 0 0 0 0 0 0 0 0 0 0 0 0 0 0 0 0 0 0 0 0 0 0 0 0 0 0 0 0 0 0 0 0 0 0 0 0 0 0 0 0 30 10 10 0 0 0 0 0 0 0 0 10 30 30 30 0 0 0 0 0 0 0 0 0 0 0 0 0 0 0 0 0 0 30 10 30 30 30 30 30 30 30 30 30 30 2 10 30 30 2 30 0 0 0 0 0 0 0 10 0 0 0 0 0 0 0 0 0 0 0 0 0 0 0 0 0 0 0 12 28 28 28 28 28 28 12 12 12 12 
0 0 0 0 0 0 0 0 0 0 0 0 0 0 0 0 0 0 0 0 0 0 0 0 0 0 0 0 0 0 0 0 0 0 0 0 0 0 0 0 0 0 0 0 0 0 0 0 0 0 0 0 0 0 0 0 0 0 0 0 0 0 0 0 0 0 0 0 0 0 0 0 0 0 0 0 0 0 0 0 0 0 0 0 0 0 0 0 0 0 0 0 0 0 0 0 0 0 0 30 10 10 0 0 0 0 0 0 0 0 0 10 10 10 30 30 30 0 10 10 10 10 10 0 0 0 0 0 0 0 0 0 0 30 10 30 30 30 30 30 30 30 30 30 10 10 10 10 10 10 10 0 0 0 0 0 0 0 10 0 0 0 0 0 0 0 0 0 0 0 0 0 0 0 0 0 0 0 12 28 28 28 28 28 28 12 
0 0 0 0 0 0 0 0 0 0 0 0 0 0 0 0 0 0 0 0 0 0 0 0 0 0 0 0 0 0 0 0 0 0 0 0 0 0 0 0 0 0 0 0 0 0 0 0 0 0 0 0 0 0 0 0 0 0 0 0 0 0 0 0 0 0 0 0 0 0 0 0 0 0 0 0 0 0 0 0 0 0 0 0 0 0 0 0 0 0 0 0 0 0 0 0 0 0 30 10 10 0 0 0 0 0 0 0 0 0 0 0 0 10 10 10 30 0 0 0 0 0 0 0 0 0 0 0 0 0 0 0 0 10 10 30 30 30 30 30 30 30 30 30 30 30 10 30 30 30 30 30 30 0 0 0 0 0 10 0 0 0 0 0 0 0 0 0 0 0 0 0 0 0 0 0 0 0 12 28 28 28 28 28 12 12 
0 0 0 0 0 0 0 0 0 0 0 0 0 0 0 0 0 0 0 0 0 0 0 0 0 0 0 0 0 0 0 0 0 0 0 0 0 0 0 0 0 0 0 0 0 0 0 0 0 0 0 0 0 0 0 0 0 0 0 0 0 0 0 0 0 0 0 0 0 0 0 0 0 0 0 0 0 0 0 0 0 0 0 0 0 0 0 0 0 0 0 0 0 0 0 0 30 30 10 10 0 0 0 0 0 0 0 0 0 0 0 0 0 0 0 10 30 0 0 0 0 0 0 0 0 0 0 0 0 0 0 0 0 30 10 30 30 30 30 30 30 30 30 30 30 30 10 30 30 30 30 30 30 0 0 0 0 0 10 0 0 0 0 0 0 0 0 0 0 0 0 0 0 0 0 0 0 0 12 28 28 28 28 28 28 12 
0 0 0 0 0 0 0 0 0 0 0 0 0 0 0 0 0 0 0 0 0 0 0 0 0 0 0 0 0 0 0 0 0 0 0 0 0 0 0 0 0 0 0 0 0 0 0 0 0 0 0 0 0 0 0 0 0 0 0 0 0 0 0 0 0 0 0 0 0 0 0 0 0 0 0 0 0 0 0 0 0 0 0 0 0 0 0 0 0 0 0 0 0 0 0 0 10 30 30 0 0 0 0 0 0 0 0 0 0 0 0 0 0 0 0 10 2 30 30 30 30 30 30 30 30 30 10 30 30 30 30 30 30 30 10 30 30 30 30 30 30 30 30 30 10 10 10 10 10 10 10 10 10 0 0 0 0 0 10 0 0 0 0 0 0 0 0 0 0 0 0 0 0 0 0 0 0 0 12 12 28 28 28 28 28 12 
0 0 0 0 0 0 0 0 0 0 0 0 0 0 0 0 0 0 0 0 26 0 0 0 0 0 0 0 0 0 0 0 0 0 0 0 0 0 0 0 0 0 0 0 0 0 0 0 0 0 0 0 0 0 0 0 0 0 0 0 0 0 0 0 0 0 0 0 0 0 0 0 0 0 0 0 0 0 0 0 0 0 0 0 0 0 0 0 0 0 0 0 0 0 0 0 10 10 30 30 0 0 0 0 0 0 0 0 0 0 0 0 0 0 0 10 10 10 10 10 10 10 10 10 10 10 10 10 10 10 10 10 10 10 10 30 30 30 30 30 30 30 30 30 30 30 10 30 30 30 30 30 30 30 30 30 10 0 10 0 0 0 0 0 0 0 0 0 0 0 0 0 0 0 0 0 0 0 12 28 28 28 28 28 28 12 
0 0 0 0 0 0 0 0 0 0 0 0 0 0 0 0 0 0 0 26 26 26 0 0 0 0 0 0 0 0 0 0 0 0 0 0 0 0 0 0 0 0 0 0 0 0 0 0 0 0 0 0 0 0 0 0 0 0 0 0 0 0 0 0 0 0 0 0 0 0 0 0 0 0 0 0 0 0 0 0 0 0 0 0 0 0 0 0 0 0 0 0 0 0 0 0 0 10 10 30 30 0 0 0 0 0 0 0 30 30 30 30 30 30 30 30 30 30 30 30 30 10 0 0 0 0 0 0 0 0 0 0 0 0 10 30 30 30 30 30 30 30 30 30 30 30 10 30 30 30 30 30 30 30 30 30 10 0 10 0 0 0 0 0 0 0 0 0 0 0 0 0 0 0 0 0 0 0 12 28 28 28 28 28 12 12 
0 0 0 0 0 0 0 0 0 0 0 0 0 0 0 0 0 0 26 26 26 26 26 0 0 0 0 0 0 0 0 0 0 0 0 0 0 0 0 0 0 0 0 0 0 0 0 0 0 0 0 0 0 0 0 0 0 0 0 0 0 0 0 0 0 0 0 0 0 0 0 0 0 0 0 0 0 0 0 0 0 0 0 0 0 0 0 0 0 0 0 0 0 0 0 0 0 0 10 10 30 30 0 0 0 0 0 0 30 30 30 30 30 30 30 30 30 30 30 30 30 10 0 0 0 0 0 0 0 0 0 0 0 0 10 10 10 10 10 10 10 10 10 10 10 10 10 10 10 10 10 10 10 10 10 10 10 0 10 0 0 0 0 0 0 0 0 0 0 0 0 0 0 0 0 0 0 0 12 28 28 28 28 28 28 12 
0 0 0 0 0 0 0 0 0 0 0 0 0 0 0 0 0 26 26 26 26 26 26 26 0 0 0 0 0 0 0 0 0 0 0 0 0 0 0 0 0 0 0 0 0 0 0 0 0 0 0 0 0 0 0 0 0 0 0 0 0 0 0 0 0 0 0 0 0 0 0 0 0 0 0 0 0 0 0 0 0 0 0 0 0 0 0 0 0 0 0 0 0 0 0 0 0 0 0 10 10 30 0 0 0 0 0 0 30 30 30 30 30 30 30 30 30 30 30 30 30 10 0 0 0 0 0 0 0 0 0 0 0 0 0 0 0 0 0 0 0 0 0 0 0 0 0 0 0 0 0 0 0 0 0 0 10 10 10 0 0 0 0 0 0 0 0 0 0 0 0 0 0 0 0 0 0 0 12 12 28 28 28 28 28 12 
0 0 0 0 0 0 0 0 0 0 0 0 0 0 0 0 0 29 29 29 29 29 29 29 0 0 0 0 0 0 0 0 0 0 0 0 0 0 0 0 0 0 0 0 0 0 0 0 0 0 0 0 0 0 0 0 0 0 0 0 0 0 0 0 0 0 0 0 0 0 0 0 0 0 0 0 0 0 0 0 0 0 0 0 0 0 0 0 0 0 0 0 0 0 0 0 0 0 0 0 0 0 0 30 30 0 0 0 30 30 30 30 30 30 30 30 30 30 30 30 30 10 0 0 0 0 0 0 0 0 0 0 0 0 0 0 0 0 0 0 0 0 0 0 0 0 0 0 0 0 0 0 0 0 0 0 0 0 0 0 0 0 0 0 0 0 0 0 0 0 0 0 0 0 0 0 0 0 12 28 28 28 28 28 28 12 
0 0 0 0 0 0 0 0 0 0 0 0 0 0 0 0 0 29 29 29 29 29 29 29 0 0 0 0 0 0 0 0 0 0 0 0 0 0 0 0 0 0 0 0 0 0 0 0 0 0 0 0 0 0 0 0 0 0 0 0 0 0 0 0 0 0 0 0 0 0 26 26 26 26 26 26 0 0 0 0 0 0 0 0 0 0 0 0 0 0 0 0 0 0 0 0 0 0 0 0 0 0 0 10 30 0 0 0 30 30 30 30 30 30 30 30 30 30 30 30 30 10 0 0 0 0 0 0 0 0 0 0 0 0 0 0 0 0 0 0 0 0 0 0 0 0 0 0 0 0 0 0 0 0 0 0 0 0 0 0 0 0 0 0 0 0 0 0 0 0 0 0 0 0 0 0 0 0 28 28 28 28 28 28 12 12 
0 0 0 0 0 0 0 0 0 0 0 0 0 0 0 0 0 29 29 29 29 29 29 29 26 0 0 0 0 0 0 0 0 0 0 0 0 0 0 0 0 0 0 0 0 0 0 0 0 0 0 0 0 0 0 0 0 0 0 0 0 0 0 0 0 0 0 0 26 26 26 26 26 26 26 26 26 26 0 0 0 0 0 0 0 0 0 0 0 0 0 0 0 0 0 0 0 0 0 0 0 0 0 10 30 0 0 0 10 10 10 10 10 10 10 10 10 10 30 30 30 10 0 0 0 0 0 0 0 0 0 0 0 0 0 0 0 0 0 0 0 0 0 0 0 0 0 0 12 12 12 12 12 12 12 12 12 12 12 12 12 12 12 12 0 0 0 0 0 0 0 0 0 0 0 0 0 0 28 28 28 28 28 28 28 12 
0 0 0 0 0 0 0 0 0 0 0 0 0 0 0 0 0 26 26 26 26 26 26 26 0 0 0 0 0 0 0 0 0 0 0 0 0 0 0 0 0 0 0 0 0 0 0 0 0 0 0 0 0 0 0 0 0 0 0 0 0 0 0 0 0 0 26 26 26 26 26 26 26 26 26 26 26 26 26 26 0 0 0 0 27 27 27 27 27 27 27 27 27 27 27 27 27 0 0 0 0 0 0 0 0 0 0 0 0 0 0 0 0 0 0 0 0 10 30 30 10 10 0 0 0 0 0 0 0 0 0 0 0 0 0 0 0 0 0 0 0 0 0 0 0 0 0 0 12 0 0 12 0 0 0 12 0 0 0 12 0 0 0 12 0 0 0 0 0 0 0 0 0 0 0 0 0 0 28 28 28 28 28 28 28 12 
0 0 0 0 0 0 0 0 0 0 0 0 0 0 0 0 0 29 29 29 29 29 29 29 0 0 0 0 0 0 0 0 0 0 0 0 0 0 0 0 0 0 0 0 0 0 0 0 0 0 0 0 0 0 0 0 0 0 0 0 0 0 0 0 26 26 26 26 26 26 26 26 26 26 26 26 26 26 26 26 26 0 0 0 27 9 9 9 9 9 9 9 9 9 9 9 27 0 0 0 0 0 0 0 0 0 0 0 0 0 0 0 0 0 0 0 0 10 30 30 30 10 0 0 0 0 0 0 0 0 0 0 0 0 0 0 0 0 0 0 0 0 0 0 0 0 0 0 12 0 0 12 0 0 0 12 0 0 0 12 0 0 0 12 0 0 0 0 0 0 0 0 0 0 0 0 0 0 12 12 12 12 12 12 12 12 
0 0 0 0 0 0 0 0 0 0 0 0 0 0 26 26 0 29 29 29 29 29 29 29 0 0 0 0 0 0 0 0 0 0 0 0 0 0 0 0 0 0 0 0 0 0 0 0 0 0 0 0 0 0 0 0 0 0 0 0 0 0 0 0 0 31 31 31 31 31 31 31 31 31 31 31 31 31 31 27 0 0 0 0 27 9 31 31 31 31 9 31 31 31 31 9 27 0 0 0 0 0 0 0 0 0 0 0 0 0 0 0 0 0 0 0 0 10 30 30 30 10 0 0 0 0 0 0 0 0 0 0 0 0 0 0 0 0 0 0 0 0 0 0 0 0 0 0 12 0 0 12 0 12 0 12 0 12 0 12 0 12 0 12 0 0 0 0 2 0 0 0 0 0 0 0 0 12 12 
0 0 0 0 0 0 0 0 0 0 0 0 0 0 0 26 26 29 29 29 29 29 29 29 0 0 0 0 0 0 0 0 0 0 0 0 0 0 0 0 0 0 0 0 0 0 0 0 0 0 0 0 0 0 0 0 0 0 0 0 0 0 0 0 0 31 31 31 31 31 31 31 31 31 31 31 31 31 31 31 0 0 0 0 27 9 31 31 31 31 9 31 31 31 31 9 27 0 0 0 0 27 27 27 27 27 0 0 0 0 0 0 0 0 0 0 0 10 10 30 30 10 0 0 0 0 0 0 0 0 0 0 7 0 0 0 0 0 0 0 7 0 0 0 0 0 0 0 12 0 0 12 0 12 0 12 0 12 0 12 0 12 0 12 0 0 0 2 2 2 0 0 0 0 0 0 12 12 
0 0 0 0 0 0 0 0 0 0 0 0 0 0 0 0 26 26 26 26 26 26 26 26 0 0 0 0 0 0 0 0 0 0 0 0 0 0 0 0 0 0 0 0 0 0 0 0 0 0 0 0 0 0 0 0 0 0 0 0 0 0 0 0 0 27 27 27 27 27 27 31 31 31 31 31 31 31 31 31 0 0 2 0 27 9 31 31 31 31 31 31 31 31 31 9 27 0 0 0 0 0 0 28 0 0 0 0 0 0 0 0 0 0 0 0 0 0 0 0 0 0 0 0 0 0 0 0 0 0 0 7 7 7 0 0 0 0 0 7 7 7 0 0 0 0 0 0 12 0 0 0 0 12 0 0 0 12 0 0 0 12 0 0 0 0 2 2 2 2 2 0 0 0 0 12 12 
0 0 0 0 0 0 0 0 0 0 0 0 0 0 0 0 0 26 29 29 29 29 29 26 0 0 0 0 0 0 0 0 0 0 0 0 0 0 0 0 0 0 0 0 0 0 0 0 0 0 0 0 0 0 0 0 0 0 0 0 0 0 0 0 0 0 27 31 31 31 31 31 31 31 2 2 31 31 31 31 0 2 2 0 27 9 31 31 31 31 31 31 31 31 31 31 31 31 0 0 0 0 0 28 0 0 0 0 0 0 0 0 0 0 0 0 0 0 0 0 0 0 0 0 0 0 0 0 0 0 7 7 7 7 7 0 0 0 7 7 7 7 7 0 0 0 0 0 12 0 0 12 12 12 12 12 12 12 12 12 12 12 12 12 12 12 12 12 12 12 12 12 
0 0 0 0 0 0 0 0 0 0 0 0 0 0 0 0 0 29 29 29 29 29 29 29 0 0 26 26 0 0 0 0 0 0 0 0 0 0 0 26 26 26 0 0 0 0 0 0 0 0 0 0 0 0 0 0 0 0 0 0 0 0 0 0 0 0 27 31 31 31 31 31 31 2 2 2 31 31 31 27 27 27 27 0 27 9 31 31 31 31 31 31 31 31 31 31 31 31 0 0 0 0 0 28 0 0 0 2 0 0 0 0 0 9 9 9 9 9 9 9 9 9 9 9 9 9 9 9 0 0 0 7 7 7 0 0 0 0 0 7 7 7 0 0 0 0 0 0 12 
0 0 0 0 0 0 0 0 0 26 26 0 0 0 0 0 0 29 29 29 29 29 29 29 0 26 26 0 0 0 0 0 0 0 0 0 0 0 26 26 26 26 26 0 0 0 0 0 0 0 0 0 0 0 0 0 0 0 0 0 0 0 0 0 0 0 27 31 2 2 31 31 31 31 31 31 31 31 31 27 0 0 0 0 27 9 9 31 31 31 31 31 31 31 31 31 31 9 0 0 0 0 0 9 0 0 2 2 2 0 0 0 0 9 31 31 31 31 31 31 31 31 31 31 31 31 31 9 0 0 0 0 7 0 0 0 7 0 0 0 7 0 0 0 0 0 0 0 12 
0 0 0 0 0 0 0 0 26 26 26 26 0 0 0 0 0 26 26 26 26 26 26 26 26 26 0 0 0 0 0 0 0 0 0 0 0 26 26 26 26 26 26 26 0 0 0 0 0 0 0 0 0 0 0 0 0 0 0 0 0 0 0 0 0 0 27 31 2 2 31 31 31 31 31 31 31 2 2 27 0 0 0 0 27 9 9 31 31 31 31 31 31 31 31 9 31 9 0 0 0 0 0 9 0 2 2 2 2 2 0 0 0 31 31 31 31 31 31 31 31 31 31 31 31 31 31 9 0 0 0 0 0 0 0 7 7 7 0 0 0 0 0 0 0 0 0 0 27 27 27 27 27 27 27 0 0 0 0 0 0 0 0 0 0 0 0 0 0 0 0 0 0 0 0 0 0 0 0 0 0 0 0 0 0 0 16 
26 0 0 0 0 0 0 26 26 26 26 26 26 0 0 0 0 0 0 0 29 0 0 0 0 0 0 0 0 0 0 0 0 0 0 26 26 26 26 26 26 26 26 26 26 26 0 0 0 0 0 0 0 0 0 0 0 0 0 0 0 0 0 0 0 0 27 31 31 31 2 31 31 31 31 31 31 2 2 27 0 0 0 0 27 9 9 9 9 9 9 9 9 9 9 9 9 9 7 7 7 7 7 9 9 9 9 9 9 9 9 9 9 9 31 31 31 31 9 9 9 9 9 9 9 9 31 9 0 0 0 0 0 0 7 7 7 7 7 0 0 0 0 0 0 0 0 0 0 31 31 0 31 31 0 0 0 0 0 0 0 0 0 0 0 0 0 0 0 0 0 0 0 0 0 0 0 0 0 0 0 0 0 0 0 16 16 
26 0 0 0 0 0 26 26 26 26 26 26 26 26 0 0 0 0 0 0 29 0 0 0 0 0 0 0 0 0 0 0 0 0 0 0 4 30 30 30 30 30 30 30 4 0 0 0 0 0 0 0 0 0 0 0 0 0 0 0 0 0 0 0 0 0 27 27 27 27 27 27 27 27 27 27 27 27 27 27 0 0 0 0 27 27 27 27 27 27 27 27 27 27 27 27 27 27 27 27 27 27 27 27 27 27 27 27 27 27 27 27 27 9 31 31 31 31 9 0 0 0 0 0 0 9 9 9 0 0 0 0 0 0 0 7 7 7 0 0 0 0 0 0 0 0 0 0 0 31 31 0 31 31 0 0 0 0 0 0 0 0 0 0 0 0 0 0 0 0 0 0 0 0 0 0 0 0 0 0 0 0 0 0 27 27 27 27 27 27 
26 26 0 0 0 0 0 29 29 29 29 29 29 0 0 0 0 0 0 0 29 0 0 0 0 0 0 0 0 0 0 0 0 0 0 0 4 30 30 30 30 30 30 30 4 0 0 0 0 0 0 0 0 0 0 0 0 0 0 0 0 0 0 0 0 0 0 0 0 0 0 0 0 0 0 0 0 0 0 0 0 0 0 0 0 0 0 0 0 0 0 0 0 0 0 0 0 0 0 0 0 0 0 0 0 0 0 0 0 0 0 0 0 9 31 31 31 31 9 0 0 0 0 0 0 0 0 0 0 0 0 0 7 0 0 0 7 0 0 0 0 0 0 0 0 0 0 0 0 31 31 0 31 31 27 27 27 27 0 0 0 0 0 0 0 0 0 0 0 0 0 0 0 0 0 0 0 0 0 0 0 0 0 0 31 0 0 0 0 31 
26 26 0 0 0 0 0 29 29 29 29 29 29 0 0 0 0 0 0 0 29 0 0 0 0 0 0 0 0 0 0 0 0 0 0 0 4 2 30 30 30 30 30 30 4 0 0 0 0 0 0 0 0 0 0 0 0 0 0 0 0 0 0 0 0 0 0 0 0 0 0 0 0 0 0 0 0 0 0 0 0 0 0 0 0 0 0 0 0 0 0 0 0 0 0 0 0 0 0 0 0 0 0 0 0 0 0 0 0 0 0 0 0 31 31 31 9 31 9 0 0 0 0 0 0 0 0 0 0 0 0 7 7 7 0 0 0 0 0 0 0 0 0 0 0 0 0 0 0 31 31 0 31 31 0 0 0 0 0 0 0 0 0 0 0 0 0 0 0 0 0 0 0 0 0 0 0 0 0 0 0 0 0 0 31 0 0 0 0 31 
26 26 26 0 0 0 0 0 0 26 26 0 0 0 0 0 0 0 0 0 29 26 26 0 0 0 0 0 0 0 0 0 0 0 0 0 4 2 2 30 30 30 30 30 4 0 0 0 0 0 0 0 0 0 0 0 0 0 0 0 0 0 0 0 0 0 0 0 0 0 0 0 0 0 0 0 0 0 0 0 0 0 0 0 0 0 0 0 0 0 0 0 0 0 0 0 0 0 0 0 0 0 0 0 0 0 0 0 0 0 0 0 0 31 31 31 9 31 9 0 0 0 0 0 0 0 0 0 0 0 7 7 7 7 7 0 0 0 0 0 0 0 0 0 0 0 0 0 0 31 31 0 31 31 0 0 0 0 0 0 0 0 0 0 0 0 0 0 0 0 0 0 0 0 0 0 0 27 27 27 27 27 0 0 31 0 0 0 0 31 
26 26 26 0 0 0 0 0 26 26 26 26 0 0 0 0 0 0 0 0 26 26 26 0 0 0 0 0 0 0 0 0 0 0 0 0 4 4 4 4 4 4 30 30 4 0 0 0 0 0 0 0 0 0 0 0 0 0 0 0 0 0 0 0 0 0 0 0 0 0 0 0 0 0 0 0 0 0 0 0 0 0 0 0 0 0 0 0 0 0 0 0 0 0 0 0 0 0 0 0 0 0 0 0 0 0 0 0 0 0 0 0 0 31 31 31 9 31 9 0 0 0 0 0 0 0 0 0 0 0 0 7 7 7 0 0 0 0 0 0 0 0 0 0 0 0 0 0 0 31 3 0 31 31 0 0 0 0 0 0 0 0 0 0 0 0 0 0 0 0 0 0 0 0 0 0 0 0 0 31 0 0 0 0 31 0 0 0 0 31 
5 5 5 0 0 0 0 26 26 26 26 26 26 0 0 0 0 0 0 26 26 26 26 0 0 0 0 0 0 0 0 0 0 0 0 0 4 30 30 30 30 30 2 30 4 0 0 0 0 0 0 0 0 0 0 0 0 0 0 0 0 0 0 0 0 0 0 0 0 0 0 0 0 0 0 0 0 0 0 0 0 0 0 0 0 0 0 0 0 0 0 0 0 0 0 0 0 0 0 0 0 0 0 0 0 0 0 0 0 0 0 0 0 9 31 31 31 31 9 0 0 0 0 0 0 0 0 7 0 0 0 0 7 0 0 0 0 7 0 0 0 0 0 0 0 0 0 0 27 27 27 27 27 27 27 0 0 0 0 0 0 0 0 0 0 0 0 0 0 0 0 0 0 0 0 0 0 0 0 31 0 0 0 0 27 27 27 27 27 27 
29 29 5 0 0 0 26 26 26 26 26 26 26 26 0 0 0 0 26 26 26 26 26 0 0 0 0 0 0 0 0 0 0 0 0 0 4 30 30 30 30 30 30 30 4 0 0 0 0 0 0 0 0 0 0 0 0 0 0 0 0 0 0 0 0 0 0 0 0 0 0 0 0 0 0 0 0 0 0 0 0 0 0 0 0 0 0 0 0 0 0 0 0 0 0 0 0 0 0 0 0 0 0 0 0 0 0 0 0 0 0 0 0 9 31 31 31 31 9 0 0 0 0 0 0 7 7 7 0 0 0 0 0 0 0 0 7 7 7 0 0 0 0 0 0 0 0 0 0 31 31 0 31 31 0 0 0 0 0 0 0 0 0 0 0 0 0 0 0 0 0 0 0 0 3 0 0 0 0 31 0 0 0 0 0 0 31 31 
29 29 5 0 0 0 0 5 29 29 29 29 5 0 0 0 0 26 26 26 26 26 26 0 0 0 0 0 0 0 0 0 0 0 0 0 4 30 30 30 30 30 30 30 4 0 0 0 0 0 0 0 0 0 0 0 0 0 0 0 0 0 0 0 0 0 0 0 0 0 0 0 0 0 0 0 0 0 0 0 0 0 0 0 0 0 0 0 0 0 0 0 0 0 0 0 0 0 0 0 0 0 0 0 0 0 0 0 0 0 0 0 0 9 31 31 31 31 9 0 0 0 0 0 0 0 0 7 7 7 0 0 0 0 0 0 0 7 0 0 0 0 0 0 0 0 0 0 0 31 31 0 31 31 0 0 0 0 27 0 0 0 0 0 27 0 0 0 0 0 27 27 27 27 27 27 0 0 0 31 0 0 0 0 0 0 31 31 
29 29 5 0 0 0 0 5 5 5 5 5 5 0 0 0 0 5 29 29 29 29 5 0 0 0 0 0 0 0 0 0 0 0 0 0 30 30 30 30 30 30 30 2 4 0 0 0 0 0 0 0 0 0 0 0 0 0 0 0 0 0 0 0 0 0 0 0 0 0 0 0 0 0 0 0 0 0 0 0 0 0 0 0 0 0 0 9 9 9 9 9 9 9 9 9 31 31 31 9 9 9 9 9 9 9 9 9 9 9 9 9 9 9 9 9 9 9 9 0 0 0 0 0 0 0 0 7 0 0 0 0 0 0 7 0 0 0 0 0 0 0 0 0 0 0 0 0 0 31 31 0 31 31 0 0 0 0 27 27 27 27 27 27 27 0 0 0 0 0 0 0 31 31 0 0 0 0 0 31 0 0 0 0 0 0 31 31 
5 5 5 0 0 0 0 30 30 30 30 30 30 0 0 0 0 29 29 29 29 29 29 0 0 0 0 0 0 26 0 0 0 0 0 0 30 30 30 30 30 30 2 1 4 0 0 0 0 0 0 0 0 0 0 0 0 0 0 0 0 0 0 0 0 0 0 0 0 0 0 0 0 0 0 0 0 0 0 0 0 0 0 0 0 0 0 9 31 31 31 31 31 31 31 31 31 31 31 31 9 0 0 0 0 0 0 0 0 0 0 0 0 0 0 0 0 0 0 0 0 0 0 0 0 0 0 0 0 0 0 0 0 0 7 7 0 0 0 0 0 0 0 0 0 0 0 0 0 31 31 0 31 31 0 0 0 0 27 0 31 31 31 0 27 0 0 0 0 0 0 0 31 31 0 0 0 0 0 27 27 27 27 27 0 0 31 31 
0 0 0 0 0 0 0 30 30 30 30 30 30 26 0 0 0 5 5 5 5 5 5 0 0 0 0 0 26 26 26 0 0 0 0 0 30 30 30 30 30 2 1 1 4 0 0 0 0 0 0 0 0 0 0 0 0 0 0 0 0 0 0 0 0 0 0 0 0 0 0 0 0 0 0 0 0 0 0 0 0 0 0 0 0 0 0 9 31 31 31 31 31 31 31 31 31 31 31 31 9 0 0 0 0 0 0 0 0 0 0 0 0 0 0 0 0 0 0 0 0 0 0 0 0 0 0 0 0 0 0 0 7 7 7 7 7 0 0 0 0 0 0 0 0 0 0 0 0 27 27 27 27 27 0 0 0 0 0 0 31 31 31 0 0 0 0 0 0 0 0 0 31 31 0 0 0 0 0 0 0 31 0 0 0 0 31 31 
0 0 0 0 26 26 0 30 30 30 30 30 26 26 26 0 0 0 0 0 29 0 0 0 0 0 0 26 26 26 26 26 0 0 0 0 4 30 30 30 2 1 1 1 4 0 0 0 0 0 0 0 0 0 0 0 0 0 0 0 0 0 0 0 0 0 0 0 0 0 0 0 0 0 0 0 0 0 0 0 0 0 0 0 0 0 0 9 31 31 31 31 31 31 31 31 31 31 31 9 9 0 0 0 0 0 0 0 0 0 0 0 0 0 0 0 0 0 0 0 0 0 0 0 0 0 0 0 0 0 0 0 0 7 7 27 27 0 0 0 0 0 0 0 0 0 0 0 0 31 31 0 31 31 0 0 0 0 0 0 31 31 31 0 0 0 0 0 0 0 0 0 31 31 0 0 0 0 0 0 0 31 0 0 0 0 31 31 
0 0 0 26 26 26 26 30 30 30 30 26 26 26 26 26 0 0 0 0 29 0 0 0 0 0 26 26 26 26 26 26 26 0 0 0 4 4 4 4 4 4 4 4 4 0 0 0 0 0 0 0 0 0 0 0 0 0 0 0 0 0 0 0 0 0 0 0 0 0 0 0 0 0 0 0 0 0 0 0 0 0 0 0 0 0 0 9 31 31 31 31 31 31 31 31 31 31 31 31 9 0 0 0 0 0 0 0 0 0 0 0 0 0 0 0 0 0 0 0 0 0 0 0 0 0 0 0 0 0 7 0 0 0 7 0 27 27 0 0 0 0 0 0 0 0 0 0 0 31 31 0 31 31 0 0 0 0 0 0 31 31 31 0 0 0 0 0 0 0 0 0 31 31 0 0 0 0 0 0 0 31 0 0 27 27 27 31 
0 0 0 5 5 5 5 30 30 30 30 5 5 5 5 5 0 0 0 5 5 5 5 5 0 0 4 30 30 30 30 30 4 0 0 0 29 29 29 29 29 29 29 29 29 0 0 0 0 0 0 0 0 0 0 0 0 0 0 0 0 0 0 0 0 0 0 0 0 0 0 0 0 0 0 0 0 0 0 0 0 0 0 0 0 0 0 9 31 31 31 31 31 31 31 31 31 31 31 31 9 0 0 0 0 0 0 0 0 0 0 0 0 0 0 0 0 0 0 0 0 0 0 0 0 0 0 0 0 7 7 7 0 0 0 0 31 27 27 0 0 0 0 0 0 0 0 0 0 31 31 0 31 31 0 0 0 0 0 0 31 31 31 0 0 0 0 0 0 0 0 0 31 31 0 0 0 0 0 0 0 31 0 0 0 31 0 31 
0 0 0 5 29 29 5 30 5 30 30 5 29 29 29 5 0 0 0 5 29 29 29 5 0 0 4 4 4 4 4 4 4 0 0 0 29 29 29 29 29 29 29 29 29 0 0 0 0 0 0 0 0 0 0 0 0 0 0 0 0 0 0 0 0 0 0 0 0 0 0 0 0 0 0 0 0 0 0 0 0 0 0 0 0 0 0 31 31 31 31 31 31 31 31 31 31 31 31 9 9 0 0 0 0 0 0 0 0 0 0 0 0 0 0 0 0 0 0 0 0 0 0 0 0 0 0 0 0 0 7 0 0 0 0 0 31 31 27 27 0 0 0 0 0 0 0 0 0 31 31 0 31 31 0 0 0 0 0 0 31 31 31 0 0 0 0 0 0 0 0 0 31 31 0 0 0 0 0 0 0 31 0 0 0 31 0 27 27 27 
0 0 0 29 29 29 29 30 5 30 30 5 29 29 29 5 0 0 0 5 29 29 29 5 0 0 29 29 29 29 29 29 29 0 0 0 29 29 29 29 29 29 29 29 29 0 0 0 0 0 0 0 0 0 0 0 0 0 0 0 0 0 0 0 0 0 0 0 0 0 0 0 0 0 0 0 0 0 0 0 0 0 0 0 0 0 0 31 31 31 31 31 31 31 31 31 31 31 31 31 9 0 0 0 0 0 0 0 0 0 0 0 0 0 0 0 0 0 0 0 0 0 0 0 0 0 0 7 0 0 0 0 0 0 0 0 31 31 0 0 0 0 0 0 0 0 0 0 0 31 31 0 31 31 0 0 0 0 0 0 31 31 31 0 0 0 0 0 0 0 0 0 31 31 0 0 0 0 0 0 27 27 27 0 0 31 0 0 31 
0 0 0 29 29 29 29 30 5 30 30 5 5 5 5 5 0 0 0 5 5 5 5 5 0 0 29 29 29 29 29 29 29 0 0 0 29 28 29 29 29 29 29 29 29 0 0 0 3 0 0 0 0 0 0 0 0 0 0 0 0 0 0 0 0 0 0 0 0 0 0 0 0 0 0 0 9 9 9 9 9 9 9 0 0 0 0 9 31 31 31 31 31 31 31 31 31 31 31 31 9 0 0 0 0 0 0 0 0 0 0 0 0 0 0 0 0 0 0 0 0 0 0 0 0 7 7 7 7 7 0 0 0 0 0 0 31 31 0 0 0 0 0 0 0 0 0 27 27 27 27 27 27 27 27 0 0 0 0 0 31 31 31 0 0 0 0 0 0 0 0 0 31 31 0 0 0 0 0 0 0 31 0 0 0 31 0 0 31 
0 0 0 5 5 5 5 5 30 30 30 29 29 29 29 29 0 0 0 29 29 29 29 29 0 0 29 29 29 29 29 29 29 0 0 0 29 29 29 29 29 29 29 29 29 0 0 0 3 0 0 0 0 0 0 0 0 0 0 0 0 0 0 0 0 0 0 0 0 0 0 0 0 0 0 0 32 32 32 32 32 32 32 0 0 0 0 9 31 31 31 31 31 31 31 31 31 31 31 9 9 0 0 0 0 0 0 0 0 0 0 0 0 0 0 0 0 0 0 0 0 0 0 0 0 7 0 7 0 7 0 0 0 0 0 0 31 31 0 0 0 0 0 0 0 0 0 0 0 0 31 31 0 0 0 0 0 0 0 0 31 31 31 0 0 0 0 0 0 0 27 27 27 27 27 27 27 27 0 0 0 31 0 0 0 31 0 0 31 
0 0 0 29 29 29 29 30 30 30 30 29 29 29 29 29 0 0 0 29 29 29 29 29 0 0 29 29 29 29 29 29 29 0 0 0 29 29 29 29 29 29 29 29 29 0 0 0 3 0 3 0 0 0 0 0 0 0 0 0 0 0 0 0 0 0 0 0 0 9 0 0 9 0 0 0 32 32 32 32 32 32 32 0 0 0 0 9 31 31 31 31 31 31 31 31 31 31 31 9 9 0 0 0 0 0 0 0 0 0 0 0 0 0 0 0 0 0 0 0 0 0 0 0 0 0 0 7 0 0 0 0 0 0 0 0 31 31 0 0 27 27 27 27 27 0 0 0 0 0 31 31 0 0 0 0 0 27 27 27 27 27 27 27 27 27 0 0 0 0 0 31 0 0 0 0 31 0 0 0 0 31 0 0 0 31 0 0 31 
5 5 0 29 29 29 29 30 30 30 30 29 29 29 29 29 0 0 0 29 29 29 29 29 0 0 29 29 29 29 29 29 29 0 0 0 29 29 5 29 29 29 29 29 29 0 3 0 3 0 3 0 0 0 0 0 0 0 0 9 9 9 9 9 0 0 0 0 0 9 9 9 9 0 0 0 32 32 32 32 32 32 32 0 0 0 0 9 9 9 9 9 9 9 9 9 9 9 9 9 9 0 0 0 0 0 0 0 0 0 0 0 0 0 0 0 0 0 0 0 0 7 0 0 0 0 0 0 0 0 0 0 0 0 0 0 31 31 0 0 0 0 31 0 0 0 0 0 0 0 31 31 0 0 0 0 0 0 0 0 31 31 31 0 0 0 0 0 0 0 0 31 0 0 0 0 31 0 0 0 0 31 0 0 0 31 0 0 31 
5 5 0 29 29 29 29 30 30 30 30 29 29 29 29 29 0 0 0 29 29 29 29 29 0 0 29 29 29 29 29 29 29 0 0 0 29 29 5 29 29 29 29 29 29 0 3 0 5 5 5 5 5 0 0 0 0 0 0 32 32 32 32 32 0 0 0 0 0 32 32 32 32 0 0 0 32 32 32 32 32 32 32 0 0 0 0 0 0 0 0 0 0 0 0 0 0 0 0 0 0 0 0 0 0 0 0 0 0 0 0 0 0 0 0 0 0 0 0 0 7 7 7 0 0 0 0 0 0 0 0 0 0 0 0 0 31 31 0 0 0 0 31 0 0 0 0 0 0 0 31 31 0 0 0 0 0 0 0 0 31 31 31 0 0 0 0 0 0 0 0 31 0 0 0 0 31 0 0 0 0 31 0 0 0 31 0 0 31 
5 5 0 29 29 29 29 30 30 30 30 29 29 29 29 29 0 0 0 29 29 29 29 29 0 0 29 29 29 29 29 29 29 0 0 0 29 29 5 29 29 29 29 29 29 0 5 5 5 5 5 5 5 5 5 0 0 0 0 32 32 32 32 32 0 0 0 0 0 32 32 32 32 0 0 0 7 7 7 7 7 7 7 0 0 0 0 0 0 0 0 0 0 0 0 0 0 0 0 0 0 0 0 0 0 0 0 0 0 0 0 0 0 0 0 0 0 0 0 7 25 25 7 7 0 0 0 0 0 0 0 0 0 0 0 0 31 3 0 0 0 0 31 0 0 0 0 0 0 0 31 31 0 0 0 0 0 0 0 0 31 31 31 0 0 0 0 0 0 0 0 31 0 0 0 0 31 0 0 0 0 31 0 0 0 31 0 0 31 
5 5 5 5 5 5 5 5 5 33 33 33 33 5 5 5 33 33 33 5 5 5 5 5 33 33 5 5 5 5 5 5 5 5 5 5 5 5 5 29 29 29 29 29 29 5 5 5 5 5 5 5 5 5 5 5 5 5 5 5 5 7 7 7 0 0 0 0 0 7 7 7 7 0 0 0 7 7 7 7 7 7 7 33 33 33 33 33 33 33 33 33 33 33 33 33 33 33 33 33 33 33 33 33 33 33 33 33 33 33 33 33 33 33 33 33 33 25 25 25 25 25 25 25 25 25 25 25 25 25 25 25 25 25 25 25 25 25 25 25 25 25 25 25 25 25 25 25 25 25 25 25 25 25 25 25 25 25 25 25 25 25 25 25 25 25 25 25 25 25 25 25 25 25 25 25 25 25 25 25 25 25 25 25 25 25 25 25 25 25 
