0 
0 
0 
0 
0 
0 
0 
0 
0 0 0 0 0 0 0 0 0 0 0 0 0 0 0 0 0 0 0 0 0 12 12 12 12 12 12 12 12 12 12 12 12 12 12 12 12 12 12 12 12 12 12 12 12 12 12 12 12 12 12 12 12 12 12 12 12 12 12 12 12 
0 0 0 0 0 0 0 0 0 0 0 0 0 0 0 0 0 0 0 0 0 12 30 30 30 30 0 0 0 0 0 0 0 0 0 0 0 30 30 30 12 0 0 0 0 0 0 0 0 0 0 0 0 12 30 30 30 30 30 30 12 
0 0 0 0 0 0 0 0 0 0 0 0 0 0 0 0 0 0 0 0 0 12 30 30 30 0 0 0 0 0 0 0 0 0 0 0 0 0 30 30 12 0 0 0 0 0 0 0 0 0 0 0 0 12 30 30 30 30 30 30 12 30 
0 0 0 0 0 0 0 0 0 0 0 0 0 0 0 0 0 0 0 0 0 12 30 30 0 0 0 0 0 0 0 0 0 0 0 0 0 0 0 30 12 12 12 12 12 12 12 12 0 0 0 0 0 12 12 12 12 12 30 30 12 12 30 
0 0 0 0 0 0 0 0 0 0 0 0 0 0 0 0 0 0 0 0 0 12 30 0 0 0 0 0 0 0 0 0 0 0 0 0 0 0 0 0 0 0 0 30 30 30 12 0 0 0 0 0 0 0 0 0 0 30 30 30 12 12 12 30 
0 0 0 0 0 0 0 0 0 0 0 0 0 0 0 0 0 0 0 0 0 12 0 0 0 0 0 12 12 12 12 12 12 12 12 12 12 0 0 0 0 0 0 0 30 30 12 0 0 0 0 0 0 0 0 0 0 30 30 30 12 12 12 12 30 30 0 0 0 0 0 0 0 0 0 0 0 0 0 0 0 0 0 0 0 0 0 0 0 0 0 0 0 0 0 0 0 0 0 0 0 0 0 0 0 0 0 0 0 0 0 0 0 0 0 0 0 0 0 0 0 0 0 0 0 0 27 27 
0 0 0 0 0 0 0 0 0 0 0 0 0 0 0 0 0 0 0 0 0 12 0 0 0 0 0 12 30 30 30 30 12 30 30 0 0 0 0 0 0 0 0 0 0 30 12 30 1 30 30 0 0 0 0 0 0 12 12 30 12 12 12 12 12 12 0 0 0 0 0 0 0 0 0 0 0 0 0 0 0 0 0 0 0 0 0 0 0 0 0 0 0 0 0 0 0 0 0 0 0 0 0 0 0 0 0 0 0 0 0 0 0 0 0 0 0 0 0 0 0 0 0 0 0 0 27 27 
0 0 0 0 0 0 0 0 0 0 0 0 0 0 0 0 0 0 0 0 0 12 0 12 0 0 0 30 30 30 30 30 12 30 30 0 0 0 0 0 0 0 0 0 0 0 12 12 12 12 12 0 0 0 0 0 12 12 30 30 12 30 30 30 30 30 0 0 0 0 0 0 0 0 0 0 0 0 0 0 0 0 0 0 0 0 0 0 0 0 0 0 0 0 0 0 0 0 0 0 0 0 0 0 0 0 0 0 0 0 0 0 0 0 0 0 0 0 0 0 0 0 0 0 0 27 27 27 27 
0 0 0 0 0 0 0 0 0 0 0 0 0 0 0 0 0 0 0 0 0 12 0 12 0 0 0 30 30 30 30 30 12 30 30 12 30 30 12 12 12 12 12 12 0 0 0 0 0 0 0 0 0 0 0 0 0 12 30 30 12 30 30 30 30 30 0 0 0 0 0 0 0 0 0 0 0 0 0 0 0 0 0 0 0 0 0 0 0 0 0 0 0 0 0 0 0 0 0 0 0 0 0 0 0 0 0 0 0 0 0 0 0 0 0 0 0 0 0 0 0 0 0 0 0 27 27 27 27 
0 0 0 0 0 0 0 0 0 0 0 0 0 0 0 0 0 0 0 0 0 12 12 12 12 12 0 30 30 30 30 30 12 12 12 12 30 30 30 30 30 30 30 12 0 0 0 0 0 0 0 0 0 0 0 0 30 12 30 12 12 30 30 30 30 30 0 12 12 12 12 12 12 12 12 12 12 12 12 12 12 12 12 12 0 0 0 12 12 12 12 12 12 12 12 12 12 12 12 12 12 12 12 12 0 0 0 0 0 0 0 0 0 0 0 0 0 0 0 0 0 0 0 0 0 27 27 27 27 
0 0 0 0 0 0 0 0 0 0 0 0 0 0 0 0 0 0 0 0 0 12 0 0 0 0 0 30 30 30 30 30 30 30 30 12 12 30 30 30 30 30 30 12 0 0 0 0 0 0 0 0 1 0 0 30 30 12 30 30 12 30 30 30 12 12 12 12 0 0 0 30 30 30 30 30 30 30 30 30 30 30 30 12 0 0 0 12 30 30 30 30 30 30 30 30 30 30 30 30 30 30 30 12 0 0 0 0 0 0 0 0 0 0 0 0 0 0 0 0 0 0 0 0 27 27 27 27 27 27 
0 0 0 0 0 0 0 0 0 0 0 0 0 0 0 0 0 0 0 0 0 12 0 0 0 0 0 30 30 30 30 30 30 30 30 12 30 30 30 30 30 30 30 12 1 0 0 0 0 0 0 0 1 1 30 30 30 12 30 30 12 30 30 30 30 30 30 12 0 0 0 30 30 30 30 30 30 30 30 30 30 30 30 12 0 0 0 12 30 30 30 30 30 30 30 30 30 30 30 30 30 30 30 30 0 0 0 0 0 0 0 0 0 0 0 0 0 0 0 0 0 0 0 0 27 27 27 27 27 27 
0 0 0 0 0 0 0 0 0 0 0 0 0 0 0 0 0 0 0 0 0 12 0 0 0 0 12 12 12 12 12 12 12 12 30 12 12 12 12 12 12 30 30 12 1 0 0 0 12 12 12 12 12 12 12 12 12 12 12 30 12 30 30 30 30 30 30 12 0 0 0 30 30 30 30 30 30 30 30 30 30 30 30 12 0 0 0 30 30 30 30 30 30 30 30 30 30 30 30 30 30 30 30 30 0 0 0 0 0 0 0 0 0 0 0 0 0 0 0 0 0 0 0 0 27 27 27 27 27 27 
0 0 0 0 0 0 0 0 0 0 0 0 0 0 0 0 0 0 0 0 0 12 0 0 0 0 12 30 30 30 0 0 30 12 30 12 30 30 30 30 30 30 30 12 12 30 30 30 12 30 30 30 30 30 30 30 30 30 30 30 12 12 30 30 30 30 30 30 0 0 0 30 30 30 30 30 30 30 30 30 30 30 30 12 2 0 0 30 30 30 30 30 30 30 30 30 30 30 30 30 30 30 30 30 0 0 0 0 0 0 0 0 0 0 0 0 0 0 0 0 0 0 0 27 27 27 27 27 27 27 27 
0 0 0 0 0 0 0 0 0 0 0 0 0 0 0 0 0 0 0 0 0 12 0 12 0 0 12 30 30 0 0 0 0 12 30 12 0 0 0 0 0 0 0 12 30 30 30 30 30 30 30 30 30 30 30 30 30 30 30 30 12 12 12 30 30 30 30 30 0 0 0 30 30 30 30 12 12 12 12 12 12 12 12 12 27 27 27 12 12 12 12 12 12 12 12 12 12 12 12 12 12 12 12 12 0 0 0 0 0 0 0 0 0 0 0 0 0 0 0 0 0 0 0 27 27 27 27 27 27 27 27 
0 0 0 0 0 0 0 0 0 0 0 0 0 0 0 0 0 0 0 0 0 12 12 12 0 0 12 30 0 0 0 0 0 12 12 12 0 0 0 0 0 0 12 12 30 30 30 30 30 30 30 30 30 30 30 30 30 30 30 12 12 12 12 12 30 30 30 30 0 0 0 30 30 30 30 12 27 27 27 27 27 27 27 27 27 27 27 27 27 27 27 27 27 27 27 27 27 27 27 27 27 27 27 27 27 0 0 0 0 27 0 0 0 0 0 0 0 0 0 0 0 0 0 27 27 27 27 27 27 27 27 
0 0 0 0 0 0 0 0 0 0 0 0 0 0 0 0 0 0 0 0 0 12 30 30 0 0 0 0 0 0 12 30 0 0 0 0 0 30 12 12 12 12 12 12 12 12 12 12 12 12 12 12 12 12 12 12 12 12 12 12 12 12 12 12 12 12 12 12 12 0 0 12 12 12 12 12 0 0 0 0 0 0 0 0 0 0 0 0 0 0 0 0 0 0 0 0 0 0 0 0 0 0 0 0 0 0 0 0 27 27 27 0 0 0 0 0 0 0 0 0 0 0 27 27 27 27 27 27 27 27 27 27 
0 0 0 0 0 0 0 0 0 0 0 0 0 0 0 0 0 0 0 0 0 12 30 0 0 0 0 0 0 0 12 30 30 0 0 0 30 30 12 30 30 0 0 0 0 0 0 0 0 0 0 0 0 0 0 0 0 30 30 30 12 30 30 30 30 30 12 30 0 0 0 12 0 0 30 12 0 0 0 0 0 0 0 0 0 0 0 0 0 0 0 0 0 0 0 0 0 0 0 0 0 0 0 0 0 0 0 0 27 27 27 0 0 0 0 0 0 0 0 0 0 0 27 27 27 27 27 27 27 27 27 27 
0 0 0 0 0 0 0 0 0 0 0 0 0 0 0 0 0 0 0 0 0 12 0 0 0 0 0 12 12 12 12 30 30 30 0 30 30 30 12 30 0 0 0 0 0 0 0 0 0 0 0 0 0 0 0 0 0 0 30 30 12 30 30 0 0 30 12 30 0 0 12 12 0 0 30 12 0 0 0 0 0 0 0 0 0 0 0 0 0 0 0 0 0 0 0 0 0 0 0 0 0 0 0 0 0 0 0 27 27 27 27 27 0 0 0 0 0 0 0 0 0 0 27 27 27 27 27 27 27 27 27 27 
0 0 0 0 0 0 0 0 0 0 0 0 0 0 0 0 0 0 0 0 0 12 0 0 0 0 0 0 0 0 12 12 12 12 12 12 12 12 12 0 0 0 0 0 0 0 0 0 0 0 0 0 0 0 0 0 0 0 0 30 12 30 0 0 0 0 12 30 0 0 0 30 0 0 30 12 0 0 0 0 0 0 0 0 0 0 0 0 0 0 0 0 0 0 0 0 0 0 0 0 0 0 0 0 0 0 0 27 27 27 27 27 0 0 0 0 0 0 0 0 0 27 27 31 31 31 31 31 31 31 31 27 27 
0 0 0 0 0 0 0 0 27 27 27 27 27 27 27 27 27 27 27 27 0 0 0 0 0 0 0 0 0 0 0 0 0 0 0 0 30 30 12 30 0 0 0 12 12 12 12 12 12 12 12 12 12 12 12 12 12 0 0 0 12 30 0 0 0 0 12 30 0 0 0 30 0 0 30 12 0 0 0 0 0 0 0 0 0 0 0 0 0 0 0 0 0 0 0 0 0 0 0 0 0 0 0 0 0 0 27 27 27 27 27 27 27 0 0 0 0 0 0 0 0 27 27 31 31 31 31 31 31 31 31 31 31 
0 0 0 0 0 0 0 0 27 31 31 31 27 31 31 31 31 31 31 31 0 0 0 0 12 12 12 12 30 0 0 0 0 0 0 0 0 30 12 30 30 0 0 0 0 0 0 0 0 0 0 0 0 0 0 0 12 0 0 0 12 0 0 0 0 0 12 12 12 12 0 30 0 0 30 12 0 0 0 0 0 0 0 0 0 0 0 0 0 0 0 0 0 0 0 0 0 0 0 0 0 0 0 0 0 0 27 27 27 27 27 27 27 0 0 0 0 0 0 0 0 27 27 31 31 31 31 31 31 31 31 31 31 
0 0 0 0 0 0 0 0 27 31 31 31 31 31 31 31 31 31 31 31 0 0 0 30 12 30 30 12 30 30 0 0 0 0 0 0 0 0 12 12 12 12 30 0 0 0 0 0 0 0 0 0 0 0 0 0 12 0 0 0 12 0 0 0 0 0 0 0 0 0 0 30 0 0 30 12 0 0 0 0 0 0 0 0 0 0 0 0 0 0 0 0 0 0 0 0 0 0 0 0 0 0 0 0 0 27 27 27 27 27 27 27 27 27 0 0 0 0 0 0 27 27 31 31 27 27 27 27 27 27 27 27 27 27 
0 0 0 0 0 0 0 0 27 31 31 31 31 31 31 31 31 31 31 31 0 0 30 30 12 30 30 12 12 12 12 12 12 12 12 30 30 30 30 30 30 12 30 30 0 0 0 0 0 0 0 0 0 0 0 0 12 0 0 0 0 0 0 0 0 0 0 0 0 0 0 30 0 0 30 12 0 0 0 0 0 0 0 0 0 0 0 0 0 0 0 0 0 0 0 0 0 0 0 0 0 0 0 0 0 27 27 27 27 27 27 27 27 27 0 0 0 0 0 0 27 27 31 31 31 31 31 31 31 31 31 31 31 27 
0 0 0 0 0 0 0 0 27 31 31 31 27 27 27 27 27 27 27 27 0 12 12 12 12 30 30 30 30 30 30 30 12 30 30 30 30 30 30 30 30 12 12 12 12 0 0 0 0 0 0 0 0 0 0 0 12 12 0 0 0 0 0 0 0 0 0 0 0 0 30 12 30 30 30 12 0 0 0 0 0 0 0 0 0 0 0 0 0 0 0 0 0 0 0 0 0 0 0 0 0 0 0 0 27 27 27 27 27 27 27 27 27 27 27 0 0 0 0 0 27 27 31 31 31 31 31 31 31 31 31 31 31 27 0 0 0 0 0 0 0 0 0 0 0 27 
0 0 0 0 0 0 0 0 27 31 31 31 31 31 31 31 31 31 31 27 0 0 0 0 12 30 30 30 30 30 30 30 12 30 30 30 30 30 30 30 30 12 30 30 12 0 0 0 0 0 0 0 0 0 0 0 30 12 0 0 0 0 0 0 0 0 0 0 0 30 30 12 30 30 30 12 0 0 0 0 0 0 0 0 0 0 0 0 0 0 0 0 0 0 0 0 0 0 0 0 0 0 0 0 27 27 27 27 27 27 27 27 27 27 27 0 0 0 0 27 27 27 2 31 31 31 31 31 31 31 31 31 31 27 27 0 0 0 0 0 0 0 0 0 0 27 
0 0 0 0 0 0 0 0 27 31 31 31 31 31 31 31 31 31 31 27 0 0 0 0 12 30 30 30 30 30 30 30 12 12 12 12 12 12 0 0 0 12 12 12 12 12 12 12 12 12 12 12 12 0 0 0 30 12 30 0 0 0 0 12 12 12 12 12 12 12 12 12 30 30 30 12 0 0 0 0 0 0 0 0 0 0 0 0 0 0 0 0 0 0 0 0 0 0 0 0 0 0 0 27 27 27 27 27 27 27 27 27 27 27 27 27 0 0 0 27 27 27 27 27 27 27 27 27 27 27 27 31 31 27 27 0 0 0 0 0 0 0 0 0 0 27 
0 0 0 0 0 0 0 0 27 27 31 31 31 31 31 31 31 31 31 27 0 0 0 0 12 30 30 30 30 30 30 30 12 30 30 30 30 12 0 0 0 0 0 0 30 30 12 30 30 0 30 30 12 0 0 0 30 12 30 30 0 0 0 0 0 12 30 30 12 30 30 30 30 30 12 12 0 0 0 0 0 0 0 0 0 0 0 0 0 0 0 0 0 0 0 0 0 0 0 0 0 0 0 27 27 27 27 27 27 27 27 27 27 27 27 27 0 0 0 27 31 31 31 31 31 31 31 31 31 31 31 31 31 27 27 0 0 0 0 0 0 0 0 0 27 27 27 8 8 8 
0 0 0 0 0 0 0 0 27 31 31 31 31 31 31 31 31 31 31 27 0 0 0 0 12 30 30 30 30 30 30 30 12 30 0 0 30 12 0 0 0 0 0 0 0 30 12 30 0 0 0 30 12 0 0 12 12 12 30 30 30 0 0 0 0 12 30 30 12 30 30 30 30 30 30 12 0 0 0 0 0 0 0 0 0 0 0 0 0 0 0 0 0 0 0 0 0 0 0 0 0 0 27 27 27 27 27 27 27 27 27 27 27 27 27 27 27 31 27 27 31 31 31 31 31 31 31 31 31 31 31 31 31 27 27 27 0 0 0 0 0 0 0 0 27 27 27 32 32 32 
0 0 0 0 0 0 0 0 27 31 31 31 31 31 31 31 31 31 31 27 0 0 0 0 12 12 12 12 12 30 30 30 12 0 0 0 0 12 12 12 0 0 0 0 0 0 12 0 0 0 0 0 12 0 0 0 0 12 12 12 12 0 0 0 30 12 30 30 30 30 30 30 30 30 30 12 0 0 0 0 0 0 0 0 0 0 0 0 0 0 0 0 0 0 0 0 0 0 0 0 0 0 27 27 27 27 27 27 27 27 27 27 27 27 27 27 27 31 27 27 27 27 27 27 31 31 31 31 31 31 31 31 2 27 27 27 0 0 0 0 0 0 0 0 27 27 27 32 32 32 
0 0 0 0 0 0 0 0 27 31 31 31 31 27 27 27 27 27 27 27 0 0 0 0 0 0 0 0 0 0 0 0 0 30 12 30 0 0 0 0 0 0 0 12 30 0 0 0 30 12 30 0 0 30 30 30 0 0 0 0 0 0 0 30 30 12 30 30 30 30 30 30 30 30 30 12 0 0 0 0 0 0 0 0 0 0 0 0 0 0 0 0 0 0 0 0 0 0 0 0 0 27 27 27 27 27 27 27 27 27 27 27 27 27 27 27 27 31 31 27 31 31 31 27 27 27 27 27 27 27 27 27 27 27 27 27 0 0 0 0 0 0 0 27 27 27 27 27 32 32 
0 0 0 0 0 0 0 0 27 31 31 31 31 31 31 31 31 31 31 27 0 0 0 0 0 0 0 0 0 0 0 0 30 30 12 30 30 30 30 30 30 30 30 12 30 30 0 30 30 12 30 30 0 30 12 30 0 0 0 0 0 0 30 30 30 12 30 30 30 30 30 30 30 30 30 12 0 0 0 0 0 0 0 0 0 0 0 0 0 0 0 0 0 0 0 0 0 0 0 0 0 27 27 27 27 27 27 27 27 27 27 27 27 27 27 27 27 27 31 31 31 31 31 31 31 31 31 27 27 27 27 27 27 31 31 31 0 0 0 0 0 0 0 27 27 27 27 27 32 32 
0 0 0 0 0 0 0 0 27 31 31 31 31 31 31 31 31 31 31 27 0 0 0 0 0 0 0 30 12 12 12 12 12 12 12 12 12 12 12 12 12 12 12 12 12 12 12 12 12 12 12 12 12 12 12 12 12 12 12 12 12 12 12 12 12 12 12 12 12 12 12 12 12 12 12 12 0 0 0 0 0 0 0 0 0 0 0 0 0 0 0 0 0 0 0 0 0 0 0 0 27 27 27 27 27 27 27 27 27 27 27 27 27 27 27 27 27 27 27 31 31 31 31 31 31 31 31 31 31 31 27 31 31 31 31 31 0 0 0 0 0 0 0 27 27 27 27 27 32 32 
0 0 0 0 0 0 0 0 27 27 31 31 31 31 31 31 31 31 31 27 0 0 0 0 0 0 0 30 0 30 0 0 0 30 0 30 0 0 0 0 0 0 0 0 0 0 0 0 0 0 0 0 0 0 0 0 0 0 0 0 0 0 0 0 0 0 0 0 0 0 0 0 0 0 0 0 0 0 0 0 0 0 0 0 0 0 0 0 0 0 0 0 0 0 0 0 0 0 0 0 27 27 27 27 27 27 27 27 27 27 27 27 27 27 27 27 27 27 27 31 31 31 31 31 31 31 31 31 31 31 31 31 31 31 31 31 27 0 0 0 0 0 27 27 27 27 27 27 27 32 
0 0 0 0 0 0 0 0 27 31 31 31 31 31 31 31 31 31 31 27 0 0 0 0 0 0 0 30 0 30 0 0 0 30 0 30 0 0 0 0 0 0 0 0 0 0 0 0 0 0 0 0 0 0 0 0 0 0 0 0 0 0 0 0 0 0 0 0 0 0 0 0 0 0 0 0 0 0 0 0 0 0 0 0 0 0 0 0 0 0 0 0 0 0 0 0 0 0 0 27 27 27 27 27 27 27 27 27 27 27 27 27 27 27 27 27 27 27 27 27 31 31 31 31 31 31 31 31 31 31 31 31 31 31 31 31 27 0 0 0 0 0 27 27 27 27 27 27 27 32 
0 0 0 0 0 0 0 0 27 31 31 31 31 31 31 31 31 31 31 27 0 0 0 0 0 0 0 12 12 12 0 0 0 30 0 30 0 0 0 0 0 0 0 0 0 0 0 0 0 0 0 0 0 0 0 0 0 0 0 0 0 0 0 0 0 0 0 0 0 0 0 0 0 0 0 0 0 0 0 0 0 0 0 0 0 0 0 0 0 0 0 0 0 0 0 0 0 0 0 27 27 27 27 27 27 27 27 27 27 27 27 27 27 27 27 27 27 27 27 27 31 31 31 31 31 31 31 31 31 31 31 31 31 31 31 27 27 27 0 0 0 0 27 27 27 27 27 27 27 32 
0 0 0 0 0 0 0 0 27 27 27 27 27 27 31 31 31 31 31 27 0 0 0 0 0 0 0 0 0 0 12 12 12 30 0 30 0 0 0 0 0 0 0 0 0 0 0 0 0 0 0 0 0 0 0 0 0 0 0 0 0 0 0 0 0 0 0 0 0 0 0 0 0 0 0 0 0 0 0 0 0 0 0 0 0 0 0 0 0 0 0 0 0 0 0 0 0 0 27 27 27 27 27 27 27 27 31 31 31 31 31 31 31 27 27 27 27 27 27 27 27 31 31 31 31 31 31 31 31 31 31 31 31 31 31 27 27 27 0 0 0 27 27 27 27 27 27 27 27 27 
0 0 0 0 0 0 0 0 31 31 31 31 31 31 31 31 31 31 27 27 0 0 0 0 0 0 0 0 0 0 0 0 0 12 12 12 0 0 0 0 0 0 0 0 0 0 0 0 0 0 0 0 0 0 0 0 0 0 0 0 0 0 0 0 0 0 0 0 0 0 0 0 0 0 0 0 0 0 0 0 0 0 0 0 0 0 0 0 0 0 0 0 0 0 0 0 0 0 31 31 31 31 31 31 31 31 31 31 31 31 31 31 31 31 31 31 31 31 31 31 31 31 31 31 31 31 31 31 31 31 31 31 31 31 31 27 27 27 0 0 0 27 27 27 27 27 27 27 27 27 
0 0 0 0 0 0 0 0 31 31 31 31 31 31 31 31 31 31 31 27 0 0 0 0 0 0 0 0 0 0 0 0 0 0 0 0 0 0 0 0 0 0 0 0 0 0 0 0 0 0 0 0 0 0 0 0 0 0 0 0 0 0 0 0 0 0 0 0 0 0 0 0 0 0 0 0 0 0 0 0 0 0 0 0 0 0 0 0 0 0 0 0 0 0 0 0 0 27 27 31 31 31 31 31 31 31 31 31 31 31 31 31 31 31 31 31 31 31 31 31 31 27 31 31 31 31 31 31 31 31 31 31 31 31 27 27 27 27 27 0 0 27 27 27 27 27 27 27 27 27 
0 0 0 0 0 0 0 0 31 31 31 31 31 31 31 31 31 31 31 27 0 0 0 0 0 0 0 1 0 0 0 0 0 0 0 0 0 0 0 0 0 0 0 0 0 0 0 0 0 0 0 0 0 0 0 0 0 0 0 0 0 0 0 0 0 0 0 0 0 0 0 0 0 0 0 0 0 0 0 0 0 0 0 0 0 0 0 0 0 0 0 0 0 0 0 0 0 27 27 31 31 31 31 31 31 31 31 31 31 31 31 31 31 31 31 31 31 31 31 31 31 27 31 31 31 31 31 31 31 31 31 31 31 31 27 27 27 27 27 0 0 27 27 27 27 27 27 27 27 27 
0 0 0 0 0 0 0 0 27 27 27 27 27 27 27 27 27 27 27 27 0 0 0 0 0 0 0 1 0 0 0 0 0 0 0 0 0 0 0 0 0 0 0 0 0 0 0 0 0 0 0 0 0 0 0 0 0 0 0 0 0 0 0 0 0 0 0 0 0 0 0 0 0 0 0 0 0 0 0 0 0 0 0 0 0 0 0 0 0 0 0 0 0 0 0 0 27 27 27 27 27 27 27 27 27 27 27 27 31 31 31 27 27 27 27 27 27 27 27 31 31 27 27 31 31 31 31 31 31 31 31 31 31 31 27 27 27 27 27 0 0 27 27 27 27 27 27 27 27 27 
5 5 5 5 25 25 25 25 25 25 25 25 25 25 25 25 25 25 25 25 33 33 33 33 33 33 33 25 25 25 25 25 25 25 25 25 25 25 25 25 25 25 25 25 25 25 25 25 25 25 25 25 25 25 25 25 25 25 25 25 25 25 25 25 25 25 25 25 25 25 25 25 25 25 25 25 33 33 33 33 33 33 33 33 33 33 33 33 33 33 33 33 33 33 33 27 27 27 27 27 27 27 27 27 27 27 27 27 33 33 33 27 27 27 27 27 27 27 27 27 27 27 27 27 27 27 27 27 33 33 33 33 33 27 27 27 27 27 27 27 33 27 27 27 27 27 27 27 27 27 
