0 
0 
0 0 0 0 0 0 0 0 0 0 0 0 0 0 0 0 0 0 0 0 0 0 0 0 0 0 0 0 0 0 0 0 0 0 0 0 0 0 0 0 0 0 0 0 0 0 0 7 7 7 7 7 7 7 7 7 7 7 7 7 7 7 7 7 7 7 7 7 7 7 7 
0 0 0 0 0 0 0 0 0 0 0 0 0 0 0 0 0 0 0 0 0 0 0 0 0 0 0 0 0 0 0 0 0 0 0 0 0 0 0 0 0 0 0 0 0 0 0 7 31 31 31 31 31 31 31 31 31 31 31 31 31 31 31 31 31 31 31 31 31 31 7 0 0 0 0 0 0 0 0 0 0 0 0 0 0 0 0 0 0 0 0 0 0 0 0 0 0 0 0 0 0 0 0 0 0 0 0 7 0 0 0 0 0 0 7 
0 0 0 0 0 0 0 0 0 0 0 0 0 0 0 0 0 0 0 0 0 0 0 0 0 0 0 0 0 0 0 0 0 0 0 0 0 0 0 0 0 0 0 0 0 0 0 7 31 31 31 31 31 31 31 31 31 31 31 31 31 31 31 31 31 31 31 31 31 31 7 0 0 0 0 0 0 0 0 0 0 0 0 0 0 0 0 0 0 0 0 0 0 0 0 0 0 0 0 0 0 0 0 0 0 0 7 30 7 0 0 0 0 7 30 7 
0 0 0 0 0 0 0 0 0 0 0 0 0 0 0 0 0 0 0 0 0 0 0 0 0 0 0 0 0 0 0 0 0 0 0 0 0 0 0 0 0 0 0 0 0 0 0 7 31 7 7 7 7 7 7 7 7 7 7 7 7 7 7 7 7 31 31 31 31 31 7 0 0 0 0 0 0 0 0 0 0 0 0 0 0 0 0 0 0 0 0 0 0 0 0 0 0 0 0 0 0 0 0 0 0 7 30 30 30 7 0 0 7 30 30 30 7 
0 0 0 0 0 0 0 0 0 0 0 0 0 0 0 0 0 0 0 0 0 0 0 0 0 0 0 0 0 0 0 0 0 0 0 0 0 0 0 0 0 0 0 0 0 0 0 7 31 31 31 31 31 31 31 31 31 31 31 31 31 31 31 31 7 31 31 31 31 31 7 2 0 0 0 0 0 0 0 0 0 0 0 0 0 0 0 0 0 0 0 0 0 0 0 0 0 0 0 0 0 0 0 0 0 7 30 30 30 7 0 0 7 30 30 30 7 
0 0 0 0 0 0 0 0 0 0 0 0 0 0 0 0 0 0 0 0 0 0 0 0 0 0 0 0 0 0 0 0 0 0 0 0 0 0 0 0 0 0 0 0 0 0 0 7 31 31 31 31 31 31 31 31 31 31 31 31 31 31 31 31 7 31 31 31 7 7 7 7 7 7 0 0 0 0 0 0 0 0 0 0 0 0 0 0 0 0 0 0 0 0 0 0 0 0 0 0 0 0 0 0 0 7 30 30 30 30 0 0 7 30 30 30 7 
0 0 0 0 0 0 0 0 0 0 0 0 0 0 0 0 0 0 0 0 0 0 0 0 0 0 0 0 0 0 0 0 0 0 0 0 0 0 0 0 0 0 0 0 0 0 0 7 7 7 7 7 7 7 7 7 7 7 7 7 7 7 31 31 7 31 31 31 31 31 31 31 31 31 0 0 0 0 0 0 0 0 0 0 0 0 0 0 0 7 0 0 0 0 0 0 0 0 0 0 0 0 0 0 0 7 30 30 30 30 0 0 30 30 30 30 7 
0 0 0 0 0 0 0 0 0 0 0 0 0 0 0 0 0 0 0 0 0 0 0 0 0 0 0 0 0 0 0 0 0 0 0 0 0 0 0 7 7 7 7 7 7 7 31 7 31 31 31 31 31 31 31 31 31 31 31 31 31 31 31 7 7 7 7 31 31 31 31 31 31 31 0 0 0 0 0 0 0 0 0 0 0 0 0 0 0 7 7 0 0 0 0 0 0 0 0 0 0 0 0 0 0 7 30 30 30 30 0 0 30 30 30 30 7 
0 0 0 0 0 0 0 0 0 0 0 0 0 0 0 0 0 0 0 0 0 0 0 0 0 0 0 0 0 0 0 0 0 0 0 0 0 0 0 7 31 31 31 31 31 31 31 7 31 31 31 31 31 31 31 31 31 31 31 31 31 31 31 31 31 31 31 31 31 31 31 31 31 31 0 0 0 2 0 0 0 0 0 0 0 0 0 0 0 7 7 7 0 0 0 0 0 0 0 0 0 0 0 0 0 7 30 2 2 7 0 0 30 30 30 30 7 
0 0 0 0 0 0 0 0 0 0 0 0 0 0 0 0 0 0 0 0 0 0 0 0 0 0 0 0 0 0 0 0 0 0 0 0 0 0 0 7 31 7 31 7 31 7 31 7 31 31 31 31 31 31 31 31 31 31 31 31 31 31 31 31 31 31 31 31 31 31 7 7 7 7 0 0 0 7 7 7 0 0 0 7 7 7 0 0 0 7 7 7 7 7 7 7 7 7 7 7 7 30 7 0 0 7 30 30 30 7 0 0 7 30 30 2 7 0 0 0 0 7 7 
0 0 0 0 0 0 0 0 0 0 0 0 0 0 0 0 0 0 0 0 0 0 0 0 0 0 0 0 0 0 0 0 0 0 0 0 0 0 0 7 31 7 31 7 31 7 31 7 31 7 7 7 7 7 7 7 7 7 7 7 7 7 7 7 7 7 7 7 7 7 7 0 0 0 7 7 7 0 0 0 7 7 7 0 0 0 7 7 7 0 0 0 0 0 7 30 30 30 30 30 30 30 7 0 0 7 30 30 30 7 0 0 7 30 30 30 7 0 0 0 7 30 30 7 
0 0 0 0 0 0 0 0 0 0 0 0 0 0 0 0 0 0 0 0 0 0 0 0 0 0 0 0 0 0 0 0 0 0 0 0 0 0 0 7 31 7 31 7 31 7 31 31 31 31 31 31 7 0 0 0 0 0 0 0 0 0 0 0 0 0 0 0 0 0 0 0 0 0 0 0 0 0 0 0 0 0 0 0 0 0 0 0 0 0 0 0 0 0 7 30 30 7 7 7 7 7 7 0 0 7 2 30 30 7 0 0 7 30 30 30 7 0 0 0 7 30 30 7 
0 0 0 0 0 0 0 0 0 0 0 0 0 0 0 0 0 0 0 0 0 0 0 0 0 0 0 0 0 0 0 0 0 0 0 0 0 0 0 7 7 7 7 7 7 7 7 7 7 7 7 7 7 0 0 0 0 0 0 0 0 0 0 0 0 0 0 0 0 0 0 0 0 0 0 0 0 0 0 0 0 0 0 0 0 0 0 0 0 0 0 0 0 0 7 30 30 7 0 0 0 0 0 0 0 7 2 2 30 7 0 0 7 2 30 30 7 0 0 0 7 30 30 7 
0 0 0 0 0 0 0 0 0 0 0 0 0 0 0 0 0 0 0 0 0 0 0 0 0 0 0 0 0 0 0 0 0 0 0 0 0 0 0 0 0 0 0 0 0 0 0 0 0 0 0 0 0 0 0 0 0 0 0 0 0 0 0 0 0 0 0 0 0 0 0 0 0 0 0 0 0 0 0 0 0 0 0 0 0 0 0 0 0 0 0 0 0 7 7 30 30 7 0 0 0 0 0 0 0 7 2 30 30 7 0 0 7 30 30 30 7 0 0 0 7 30 30 7 
0 0 0 0 0 0 0 7 7 7 7 7 7 7 7 7 7 7 7 7 7 7 0 0 0 0 0 0 0 0 0 0 31 0 0 0 0 0 0 0 0 0 0 0 0 0 0 0 0 0 0 0 0 0 0 0 0 0 0 0 0 0 0 0 0 0 0 0 0 0 0 0 0 0 0 0 0 0 0 0 0 0 0 0 0 0 0 0 0 0 0 0 0 7 30 30 7 7 0 0 7 7 7 7 7 7 30 30 30 7 0 0 7 30 30 30 7 0 0 0 7 2 30 7 
0 0 0 0 0 0 0 7 30 30 30 30 30 30 30 30 30 30 30 30 30 7 0 0 0 0 0 0 0 0 0 0 7 0 0 0 0 0 0 0 0 0 0 0 0 0 0 0 0 0 0 0 0 0 0 0 0 0 0 0 0 0 0 0 0 0 0 0 0 0 0 0 0 0 0 0 0 0 0 0 0 0 0 0 0 0 0 0 0 0 0 0 0 7 30 30 30 7 0 0 7 30 30 30 30 30 30 30 2 7 0 0 7 30 30 2 7 0 0 0 30 30 30 7 
0 0 0 0 0 0 0 7 30 30 7 7 7 7 7 7 7 7 7 30 30 7 0 0 0 0 0 0 0 0 0 0 0 0 31 31 0 0 0 0 31 31 31 0 0 0 0 0 0 0 0 0 0 0 0 0 0 0 0 0 0 0 0 0 0 0 0 0 0 0 0 0 0 0 0 0 0 0 0 0 0 0 0 0 0 0 0 0 0 0 0 0 0 7 30 30 30 7 0 0 7 30 30 30 30 30 30 2 2 7 0 0 7 30 30 30 30 0 0 0 30 30 30 7 
0 0 0 0 0 0 0 7 30 30 30 30 30 30 30 30 30 30 30 30 30 7 0 0 0 0 0 0 0 0 0 0 0 0 7 7 0 0 0 0 7 7 7 31 31 0 0 0 0 0 0 0 0 0 0 0 0 0 0 0 0 0 0 0 0 0 0 0 0 0 0 0 0 0 0 0 0 0 0 0 0 0 0 0 0 0 0 0 0 0 0 0 0 7 7 30 30 7 0 0 7 30 30 30 30 30 2 2 2 7 0 0 7 30 30 30 30 0 0 0 30 30 2 7 
0 0 0 0 0 0 0 7 30 30 30 30 30 30 30 30 30 30 30 30 30 7 0 0 0 0 0 0 0 0 0 0 0 0 0 0 0 0 0 0 0 0 0 7 7 0 31 31 0 0 0 0 0 0 0 0 0 0 0 0 0 0 0 0 0 0 0 0 0 0 0 0 0 0 0 0 0 0 0 0 0 0 0 0 0 0 0 0 0 0 0 0 0 7 7 30 30 30 0 0 30 30 30 7 7 7 7 7 7 7 0 0 7 7 7 7 7 7 0 0 7 7 7 7 
0 0 0 0 0 0 0 7 30 30 7 7 7 30 30 30 30 30 30 30 7 7 0 0 0 0 0 0 0 0 0 0 0 0 0 0 0 0 0 0 0 0 0 0 0 0 7 7 0 0 31 31 0 0 0 0 0 0 0 0 0 0 0 0 0 0 0 0 0 0 0 0 0 0 0 0 0 0 0 0 0 0 0 0 0 0 0 0 0 0 0 0 0 7 7 30 30 30 
0 0 0 0 0 0 0 7 30 30 30 30 7 30 30 30 30 30 30 7 7 7 0 0 0 0 0 0 0 0 0 0 0 0 0 0 0 0 0 0 0 0 0 0 0 0 0 0 0 0 7 7 0 0 0 0 31 31 0 0 0 0 0 0 0 0 0 0 0 0 0 0 0 0 0 0 0 0 0 0 0 0 0 0 0 0 0 0 0 0 0 0 0 7 7 7 7 7 
0 0 0 0 0 0 0 7 7 30 30 30 7 30 30 30 30 30 7 7 30 30 0 0 0 0 0 0 0 0 0 0 0 0 0 0 0 0 0 0 0 0 0 0 0 0 0 0 0 0 0 0 0 0 0 0 7 7 0 0 0 0 31 31 0 0 0 0 0 0 0 0 0 0 0 0 0 0 0 0 0 0 0 0 0 0 0 0 0 0 0 0 0 0 0 0 0 7 7 7 
0 0 0 0 0 0 0 7 30 30 30 30 7 30 30 30 30 30 30 30 30 30 0 0 1 0 0 0 0 0 0 0 0 0 0 0 0 0 0 0 0 0 0 0 0 0 0 0 0 0 0 0 0 0 0 0 0 0 0 0 0 0 7 7 0 0 0 0 31 31 0 0 0 31 31 31 31 31 31 31 
0 0 0 0 0 0 0 7 30 7 30 30 7 7 7 7 7 7 7 7 7 7 0 0 0 0 0 0 0 0 0 0 0 0 0 0 0 0 0 0 0 0 0 0 0 0 0 0 0 0 0 0 0 0 0 0 0 0 0 0 0 0 0 0 0 0 0 0 7 7 0 0 0 7 7 7 7 7 7 7 0 0 7 32 7 0 0 0 0 7 
0 0 0 0 0 0 0 7 30 7 7 30 30 30 7 7 30 30 30 30 30 30 0 0 0 0 0 0 0 0 0 0 0 0 0 0 0 7 0 0 0 0 0 0 0 0 0 0 0 0 0 0 0 0 0 0 0 0 0 0 0 0 0 0 0 0 0 0 0 0 0 0 0 0 0 0 0 0 0 0 0 0 7 32 7 0 0 0 7 7 32 7 0 0 0 0 0 0 0 0 0 0 7 
0 0 0 0 0 0 0 7 30 7 30 30 30 7 7 30 30 30 30 30 30 30 0 0 0 7 7 7 7 7 0 0 0 0 0 0 0 7 0 0 0 0 0 0 0 0 0 0 0 0 0 0 0 0 0 0 0 0 0 0 0 0 0 0 0 0 0 0 0 0 0 0 0 0 0 0 0 0 32 32 32 0 7 7 7 0 0 0 7 32 32 7 0 0 0 0 0 0 0 0 0 7 32 7 
0 0 0 0 0 0 0 7 7 7 30 30 30 7 30 30 30 30 30 30 30 30 0 0 7 30 30 7 0 0 0 0 0 0 0 0 0 7 0 0 0 0 0 0 0 0 0 0 0 0 0 0 0 0 0 0 0 0 0 0 0 0 0 0 0 0 0 0 0 0 0 0 0 0 0 32 32 32 32 32 32 0 0 0 0 0 0 0 7 32 32 32 7 0 0 0 0 0 0 0 0 0 7 0 0 0 0 0 0 0 0 0 0 7 7 7 7 7 7 7 7 7 7 7 7 7 
0 0 0 0 0 0 0 7 30 30 30 30 7 30 30 30 30 30 30 30 30 30 30 30 30 30 30 7 0 0 0 0 0 0 0 0 0 7 0 7 7 7 0 0 0 0 0 0 0 0 32 0 0 0 0 32 0 0 32 0 0 32 0 0 0 0 0 32 0 0 0 0 32 32 32 32 32 32 7 7 7 0 0 0 0 0 0 0 7 7 7 7 7 0 0 0 0 7 32 32 32 0 0 0 0 7 0 0 0 0 0 0 0 7 31 31 31 31 31 31 31 31 31 31 31 7 
0 0 0 0 0 0 0 7 7 7 7 7 7 7 7 7 7 7 7 7 7 7 7 30 30 30 30 7 0 0 0 2 0 0 0 0 0 7 0 0 0 7 0 0 0 0 0 0 0 0 32 0 0 0 0 32 0 0 32 0 0 32 0 0 0 0 0 32 0 0 0 0 32 32 32 7 7 7 0 0 0 0 0 0 0 0 0 0 0 0 0 0 0 0 0 0 0 7 32 32 32 0 0 0 0 7 0 0 0 0 0 0 0 7 31 31 31 31 31 31 31 31 31 31 31 7 
0 0 0 0 0 0 0 0 0 0 0 0 0 0 0 0 0 0 0 0 0 0 0 7 30 30 30 7 7 7 7 7 7 0 0 0 0 7 0 0 0 7 7 7 7 7 0 0 0 0 7 0 0 0 0 7 0 0 7 0 0 7 0 0 0 0 0 7 0 0 0 0 7 7 7 0 0 0 0 0 0 0 0 0 0 0 0 0 0 0 0 0 0 0 0 0 0 7 7 7 32 0 0 0 0 7 0 0 0 0 0 0 0 7 31 31 31 31 31 31 31 31 31 31 31 7 
0 0 0 0 0 0 0 0 0 0 0 0 0 0 0 0 0 0 0 0 0 0 0 0 7 30 30 30 30 30 7 30 7 0 0 0 0 7 0 0 0 7 30 30 30 7 0 0 0 0 0 0 0 0 0 0 0 0 0 0 0 0 0 0 0 0 0 0 0 0 0 0 0 0 0 0 0 0 0 0 0 0 0 0 0 0 0 0 0 0 0 0 0 0 0 0 0 32 32 7 7 0 0 0 0 7 0 0 0 0 0 0 0 7 31 31 31 31 31 31 31 31 31 31 31 31 
0 0 0 0 0 0 0 0 0 0 0 0 0 0 0 0 0 0 0 0 0 0 0 0 0 7 30 30 30 30 7 30 7 7 0 0 0 0 0 0 0 7 30 30 30 7 0 0 0 0 0 0 0 0 0 0 0 0 0 0 0 0 0 0 0 0 0 0 0 0 0 0 0 0 0 0 0 0 0 0 0 0 0 0 0 0 0 0 0 0 0 0 0 0 0 0 0 0 0 0 0 0 0 0 0 7 0 0 0 0 0 0 0 7 31 31 31 31 31 31 31 31 31 31 31 31 
0 0 0 0 0 0 0 0 0 0 0 0 0 0 0 0 0 0 0 0 0 0 0 0 0 0 7 30 30 30 7 30 7 7 7 7 7 7 7 7 7 7 30 30 30 7 0 0 0 0 0 0 0 0 0 0 0 0 0 0 0 0 0 0 0 0 0 0 0 0 2 0 0 0 0 0 0 0 0 0 0 0 0 0 0 0 0 0 0 0 0 0 0 0 0 0 0 0 0 0 0 0 0 0 0 7 0 0 0 0 0 0 0 7 31 31 7 7 7 7 7 7 7 7 7 7 
0 0 0 0 0 0 0 0 0 0 0 0 0 0 0 0 0 0 0 0 0 0 0 0 0 0 0 7 30 30 30 30 30 30 30 30 30 30 30 30 30 30 30 30 30 7 0 0 0 0 0 0 0 0 0 0 0 0 0 0 0 16 16 16 16 16 16 16 16 16 16 16 16 16 16 16 16 16 16 0 0 0 0 0 0 0 0 0 0 0 0 0 0 0 0 0 0 0 0 0 0 0 0 0 1 7 0 0 0 0 0 0 0 31 31 31 7 33 33 33 33 33 33 33 33 7 
0 0 0 0 0 0 0 0 0 0 0 0 0 0 0 0 0 0 0 0 0 0 0 0 0 0 0 0 7 7 7 7 7 7 7 7 7 7 7 7 7 7 7 30 7 7 0 0 0 0 0 0 0 0 0 0 0 0 7 0 0 16 16 16 16 16 16 16 16 16 16 16 16 16 16 16 16 16 16 0 0 0 0 0 0 0 0 0 0 0 0 0 0 0 0 0 0 0 0 0 0 0 0 1 1 7 0 0 0 0 0 0 0 7 31 31 7 33 33 33 33 33 33 33 33 7 
0 0 0 0 0 0 0 0 0 0 0 0 0 0 0 0 0 0 0 0 0 0 0 0 0 0 0 0 0 0 0 0 0 0 0 0 0 0 0 0 0 0 0 0 0 0 0 0 0 0 0 0 0 0 0 0 0 0 7 0 0 16 0 0 0 0 16 0 0 0 16 0 0 0 16 0 0 0 16 0 0 0 0 0 0 0 0 0 0 0 0 0 0 0 0 0 0 0 0 0 0 0 7 7 7 7 0 0 0 7 0 0 0 7 7 7 7 7 7 7 7 7 7 7 7 7 7 7 7 
0 0 0 0 0 0 0 0 0 0 0 0 0 0 0 0 0 0 0 0 0 0 0 0 0 0 0 0 0 0 0 0 0 0 0 0 0 0 0 0 0 0 0 0 0 0 0 0 0 0 0 0 0 0 0 0 0 0 7 0 0 16 0 0 0 0 16 0 0 0 16 0 0 0 0 0 0 0 16 0 0 0 0 0 0 0 0 0 0 0 0 0 0 0 0 0 0 0 0 0 0 0 0 0 0 0 0 0 7 7 0 0 0 7 30 30 30 30 30 30 30 30 30 30 30 7 32 32 7 
0 0 0 0 0 0 0 0 0 0 0 0 0 0 0 0 0 0 0 0 0 0 0 0 0 0 0 0 0 0 0 0 0 0 0 0 0 0 0 0 0 0 0 0 0 0 0 0 0 0 0 0 0 0 0 0 0 1 7 0 0 16 0 0 0 0 16 0 0 0 16 0 0 0 16 0 0 0 1 0 0 0 0 0 0 0 0 0 0 0 0 0 0 0 0 0 0 0 0 0 0 0 0 0 0 0 0 7 7 7 0 0 0 7 30 30 30 30 30 30 30 30 30 30 30 7 32 32 7 7 7 
0 0 0 0 0 0 0 0 0 0 0 0 0 0 0 0 0 0 0 0 0 0 0 0 0 0 0 0 0 0 0 0 0 0 0 0 0 0 0 0 0 0 0 0 0 0 0 0 0 0 0 0 0 0 0 0 1 1 7 0 0 16 0 0 0 0 16 0 0 0 16 0 0 0 16 0 0 0 0 0 0 0 0 0 0 0 0 0 0 0 7 7 7 7 7 7 7 0 0 0 7 7 7 7 7 7 7 7 7 7 0 0 0 7 30 30 30 30 30 30 30 30 30 30 30 7 32 32 32 32 7 
0 0 0 0 0 0 0 0 0 0 0 0 0 0 0 0 0 0 0 0 0 0 0 0 0 0 0 0 0 0 0 0 0 0 0 0 0 0 0 0 0 0 0 0 0 0 0 0 0 0 0 0 0 0 0 1 1 1 7 0 0 16 0 0 0 0 16 0 0 0 16 0 0 0 16 0 0 0 0 0 0 0 0 0 0 0 0 0 0 7 7 0 0 0 0 0 0 0 0 0 0 0 0 0 0 0 0 0 0 0 0 0 0 30 30 30 30 30 30 30 30 30 30 30 30 7 32 32 32 32 7 
0 0 0 0 0 0 7 7 7 7 7 7 7 7 7 0 0 7 7 7 7 7 7 7 7 7 7 7 7 7 7 7 7 0 0 0 0 7 7 7 7 7 7 7 7 7 7 7 7 7 7 7 7 7 7 7 7 7 7 0 0 16 0 0 0 0 16 0 0 0 0 0 0 0 16 0 0 0 16 0 0 0 0 0 0 0 0 0 7 7 0 0 0 0 0 0 0 0 0 0 0 0 0 0 0 0 0 0 0 0 0 0 0 30 30 30 30 30 30 30 30 30 30 30 30 32 32 32 32 32 7 7 
0 0 0 0 0 0 7 7 33 33 33 33 33 7 7 0 0 7 30 30 30 30 30 30 30 30 30 30 30 30 30 7 0 0 0 0 0 0 7 30 30 7 30 30 30 30 30 30 30 30 30 30 30 30 30 30 30 30 7 0 0 16 0 0 0 0 0 0 0 0 0 0 0 0 16 2 0 0 16 0 0 0 0 0 0 0 0 7 7 0 0 0 0 0 0 0 0 0 0 7 0 0 0 0 0 0 0 0 0 0 0 0 0 7 30 30 30 30 30 30 30 30 30 30 7 7 7 32 32 32 7 
0 0 0 0 0 0 7 7 33 33 33 33 33 7 7 0 0 30 30 30 30 30 30 30 30 30 30 30 30 30 30 7 0 0 0 0 0 0 7 30 30 7 7 30 30 30 30 30 30 30 30 30 30 30 30 30 30 30 30 0 0 16 0 0 0 0 0 0 0 16 16 16 0 0 0 0 0 0 16 0 0 0 0 0 0 0 7 7 0 0 0 0 0 0 0 0 0 0 0 7 0 0 0 0 0 0 0 0 0 0 0 0 0 7 30 30 30 30 30 30 30 30 30 7 7 7 7 32 32 32 7 
0 0 0 0 0 0 7 7 33 33 33 33 33 7 7 0 0 30 30 30 30 30 30 30 30 30 30 30 30 30 30 7 0 0 0 0 0 0 7 30 30 30 7 7 30 30 30 30 30 30 30 30 30 30 30 30 30 30 30 0 0 16 0 0 0 16 16 16 0 0 16 0 0 0 0 0 0 0 16 0 0 16 0 0 0 7 7 32 32 32 7 7 7 7 7 7 7 7 7 7 7 7 7 7 7 7 7 7 7 7 7 0 0 7 7 7 7 7 7 7 7 7 7 7 7 7 7 32 32 32 7 0 0 7 7 7 
0 0 0 0 0 0 7 7 7 7 7 7 7 7 7 0 0 7 30 30 0 30 30 30 30 30 30 0 30 30 30 7 0 0 0 0 0 0 7 30 30 30 30 30 30 30 30 30 30 30 30 30 30 30 30 30 30 30 7 0 0 0 0 0 0 0 16 0 0 0 16 0 0 16 16 16 0 0 16 0 0 16 0 0 7 7 32 32 32 32 7 32 32 32 32 32 32 32 32 32 32 32 32 32 32 32 32 32 32 32 32 32 32 32 32 32 32 32 32 32 32 32 32 32 32 32 32 32 32 7 7 
0 0 0 0 0 0 0 0 0 0 0 0 0 0 0 0 0 7 30 30 30 30 30 30 30 30 30 30 30 30 30 7 0 0 0 0 0 0 7 30 30 30 30 30 30 30 7 30 30 30 30 30 30 30 30 30 30 30 7 0 0 0 0 0 0 0 16 0 0 0 16 0 0 0 16 0 0 0 0 0 0 16 0 7 7 32 32 32 32 32 7 32 32 32 32 32 32 32 32 32 32 32 32 32 32 32 32 32 32 32 32 32 32 32 32 32 32 32 32 32 32 32 32 32 32 32 32 32 32 7 7 
0 0 0 0 0 0 0 0 0 0 0 0 0 0 0 0 7 7 30 30 30 30 30 30 30 30 30 30 30 30 30 30 0 0 0 0 0 0 30 30 30 30 30 30 30 30 7 7 30 30 30 30 30 30 30 30 30 30 7 0 0 0 0 0 0 2 16 0 0 0 16 0 0 0 16 0 0 0 0 0 2 16 7 7 32 32 32 32 32 32 32 32 32 32 32 32 32 32 32 32 32 32 32 32 32 32 32 32 32 32 32 32 32 32 32 32 32 32 32 32 32 32 32 32 32 32 32 32 32 7 7 
7 7 7 7 7 7 7 7 7 7 7 7 7 7 7 7 7 7 7 7 7 7 7 7 7 7 7 7 7 7 7 7 7 7 7 7 7 7 7 7 7 7 7 7 7 7 7 7 7 7 7 7 7 7 7 7 7 7 7 7 7 7 7 7 7 7 16 33 33 33 16 33 33 33 16 7 7 7 7 7 7 7 7 7 7 7 7 7 7 7 7 7 7 7 7 7 7 7 7 7 7 7 7 7 7 7 7 7 7 7 7 7 7 7 7 7 7 7 7 7 7 7 7 7 7 7 7 7 7 7 7 33 33 33 33 33 4 4 4 4 4 4 4 4 4 4 4 4 4 4 
